 5 3 1 0 1 2 3 4 5
 1 5 5 1 4 3 1 5 3 0
 1 1 5 2 1 4 3 -2 3 4 2 2 5 -2 1
 5 16 20 6 3 2 1 4 3 1
 1 -1 6 2 -1 4 3 1 2 4 -1 1 1 -1 11 2 -1 9 3 1 7 5 -1 1 1 -1 15 2 -1 13 4 1 7 5
 -1 2 1 -2 16 3 1 12 4 -1 8 5 1 3 2 -2 16 3 1 14 4 -1 10 5 1 5
 16 16 48 26 2 1 1 3 2 1
 1 -1 5 2 -1 3 3 1 1 1 -1 9 2 -1 7 4 1 1 1 -2 10 3 1 6 4 -1 2 1 0 5 3 -1 7 4 1 3
 2 -2 10 3 1 8 4 -1 4 2 0 5 3 -1 9 4 1 5 1 -1 14 2 -1 12 5 1 1 1 -2 15 3 1 11 5
 -1 2 1 0 5 3 -1 12 5 1 3 2 -2 15 3 1 13 5 -1 4 2 0 5 3 -1 14 5 1 5 1 -2 16 4 1
 11 5 -1 6 1 0 5 4 -1 12 5 1 7 2 -2 16 4 1 13 5 -1 8 2 0 5 4 -1 14 5 1 9 3 -1 16
 4 1 15 5 -1 10
 16 5 32 74 1 0 1 2 1 1
 1 1 2 2 1 1 1 -2 3 3 1 1 1 0 2 3 1 1 2 -2 3 3 1 2 2 0 2 3 1 2 1 -2 4 4 1 1 1 0
 2 4 1 1 2 -2 4 4 1 2 2 0 2 4 1 2 3 -1 4 4 1 3 1 -2 5 5 1 1 1 0 2 5 1 1 2 -2 5 5
 1 2 2 0 2 5 1 2 3 -1 5 5 1 3 4 -1 5 5 1 4
 5 1 5 106 0 0 0 1 0 1
 1 1 1 2 1 1 3 1 1 4 1 1 5 1 1
 1 16 20 111 3 2 1 5 3 0
 0 -2 16 0 2 15 0 -2 11 0 2 6 0 -2 16 0 2 13 0 -2 9 0 2 4 0 1 14 0 1 12 0 2 7 0
 -2 2 0 -1 10 0 -1 8 0 -2 7 0 2 1 0 1 5 0 1 3 0 2 2 0 -2 1
 1 16 60 131 2 1 1 5 3 0
 0 0 16 0 0 16 0 0 16 0 2 16 0 2 14 0 -2 9 0 -2 15 0 -2 14 0 2 5 0 2 10 0 2 9 0
 -2 5 0 0 16 0 0 16 0 0 16 0 2 16 0 2 12 0 -2 7 0 -2 15 0 -2 12 0 2 3 0 2 10 0 2
 7 0 -2 3 0 -2 16 0 -2 14 0 2 9 0 -2 16 0 -2 12 0 2 7 0 1 13 0 1 11 0 -2 1 0 -1
 8 0 -1 6 0 2 1 0 2 15 0 2 14 0 -2 5 0 2 15 0 2 12 0 -2 3 0 -1 13 0 -1 11 0 2 1
 0 1 4 0 1 2 0 -2 1 0 -2 10 0 -2 9 0 2 5 0 -2 10 0 -2 7 0 2 3 0 1 8 0 1 6 0 -2 1
 0 -1 4 0 -1 2 0 2 1
 1 5 120 191 1 0 1 5 3 0
 0 0 5 0 0 5 0 0 5 0 0 5 0 0 5 0 0 5 0 0 5 0 0 5 0 -2 5 0 -2 2 0 2 4 0 2 2 0 0 5
 0 0 5 0 2 5 0 2 2 0 -2 3 0 -2 2 0 0 5 0 0 5 0 -2 4 0 -2 2 0 2 3 0 2 2 0 0 5 0 0
 5 0 0 5 0 0 5 0 0 5 0 0 5 0 0 5 0 0 5 0 -2 5 0 -2 1 0 2 4 0 2 1 0 0 5 0 0 5 0 2
 5 0 2 1 0 -2 3 0 -2 1 0 0 5 0 0 5 0 -2 4 0 -2 1 0 2 3 0 2 1 0 0 5 0 0 5 0 2 5 0
 2 2 0 -2 4 0 -2 2 0 0 5 0 0 5 0 2 5 0 2 1 0 -2 4 0 -2 1 0 -2 5 0 -2 2 0 -2 5 0
 -2 1 0 1 2 0 1 1 0 2 4 0 2 2 0 2 4 0 2 1 0 -1 2 0 -1 1 0 0 5 0 0 5 0 -2 5 0 -2
 2 0 2 3 0 2 2 0 0 5 0 0 5 0 -2 5 0 -2 1 0 2 3 0 2 1 0 2 5 0 2 2 0 2 5 0 2 1 0 -1
 2 0 -1 1 0 -2 3 0 -2 2 0 -2 3 0 -2 1 0 1 2 0 1 1 0 0 5 0 0 5 0 2 4 0 2 2 0 -2 3
 0 -2 2 0 0 5 0 0 5 0 2 4 0 2 1 0 -2 3 0 -2 1 0 -2 4 0 -2 2 0 -2 4 0 -2 1 0 1 2
 0 1 1 0 2 3 0 2 2 0 2 3 0 2 1 0 -1 2 0 -1 1
 1 7 20 311 3 3 0 5 3 0
 0 1 7 0 -2 6 0 2 4 0 -2 2 0 1 7 0 -2 5 0 2 3 0 -2 1 0 -2 6 0 -2 5 0 0 7 0 0 7 0
 2 4 0 2 3 0 0 7 0 0 7 0 -2 2 0 -2 1 0 0 7 0 0 7
 7 9 21 331 2 2 0 3 3 0
 1 1 5 3 -1 3 4 1 1 2 1 5 3 -1 4 4 1 2 1 1 8 3 -1 6 5 1 1 2 1 8 3 -1 7 5 1 2 1 1
 9 4 -1 6 5 1 3 2 1 9 4 -1 7 5 1 4 3 1 9 4 -1 8 5 1 5
 9 5 18 352 1 1 0 2 2 0
 1 1 3 3 -1 1 2 1 3 3 -1 2 1 1 4 4 -1 1 2 1 4 4 -1 2 3 1 4 4 -1 3 1 1 5 5 -1 1 2
 1 5 5 -1 2 3 1 5 5 -1 3 4 1 5 5 -1 4
 5 1 5 370 0 0 0 1 1 0
 1 1 1 2 1 1 3 1 1 4 1 1 5 1 1
 1 9 60 375 2 2 0 5 3 0
 0 -2 9 0 2 8 0 -2 5 0 -2 9 0 0 9 0 0 9 0 2 8 0 0 9 0 0 9 0 -2 5 0 0 9 0 0 9 0 -2
 9 0 2 8 0 -2 5 0 -2 9 0 0 9 0 0 9 0 2 8 0 0 9 0 0 9 0 -2 5 0 0 9 0 0 9 0 1 9 0
 -2 7 0 2 4 0 1 9 0 -2 6 0 2 3 0 -2 7 0 -2 6 0 0 9 0 2 4 0 2 3 0 0 9 0 -1 8 0 2
 7 0 -2 2 0 -1 8 0 2 6 0 -2 1 0 2 7 0 2 6 0 0 9 0 -2 2 0 -2 1 0 0 9 0 1 5 0 -2 4
 0 2 2 0 1 5 0 -2 3 0 2 1 0 -2 4 0 -2 3 0 0 9 0 2 2 0 2 1 0 0 9
 1 5 120 435 1 1 0 5 3 0
 0 0 5 0 0 5 0 0 5 0 0 5 0 0 5 0 0 5 0 2 5 0 -2 4 0 2 5 0 0 5 0 -2 4 0 0 5 0 -2
 5 0 2 3 0 -2 5 0 0 5 0 2 3 0 0 5 0 2 4 0 -2 3 0 2 4 0 0 5 0 -2 3 0 0 5 0 0 5 0
 0 5 0 0 5 0 0 5 0 0 5 0 0 5 0 2 5 0 -2 4 0 2 5 0 0 5 0 -2 4 0 0 5 0 -2 5 0 2 3
 0 -2 5 0 0 5 0 2 3 0 0 5 0 2 4 0 -2 3 0 2 4 0 0 5 0 -2 3 0 0 5 0 -2 5 0 2 4 0 -2
 5 0 0 5 0 2 4 0 0 5 0 -2 5 0 2 4 0 -2 5 0 0 5 0 2 4 0 0 5 0 1 5 0 -2 2 0 1 5 0
 -2 1 0 -2 2 0 -2 1 0 -1 4 0 2 2 0 -1 4 0 2 1 0 2 2 0 2 1 0 2 5 0 -2 3 0 2 5 0 0
 5 0 -2 3 0 0 5 0 2 5 0 -2 3 0 2 5 0 0 5 0 -2 3 0 0 5 0 -1 5 0 2 2 0 -1 5 0 2 1
 0 2 2 0 2 1 0 1 3 0 -2 2 0 1 3 0 -2 1 0 -2 2 0 -2 1 0 -2 4 0 2 3 0 -2 4 0 0 5 0
 2 3 0 0 5 0 -2 4 0 2 3 0 -2 4 0 0 5 0 2 3 0 0 5 0 1 4 0 -2 2 0 1 4 0 -2 1 0 -2
 2 0 -2 1 0 -1 3 0 2 2 0 -1 3 0 2 1 0 2 2 0 2 1
 1 5 5 555 4 2 0 5 3 0
 1 -2 5 2 -2 4 3 1 3 4 -1 2 5 1 1
 5 9 20 560 3 1 0 4 2 0
 1 -2 4 2 -2 3 3 1 2 4 -1 1 1 -2 7 2 -2 6 3 1 5 5 -1 1 1 -2 9 2 -2 8 4 1 5 5 -1
 2 1 0 4 3 -1 8 4 1 6 5 -1 3 2 0 4 3 -1 9 4 1 7 5 -1 4
 9 7 27 580 2 0 0 3 1 0
 1 -2 3 2 -2 2 3 1 1 1 -2 5 2 -2 4 4 1 1 1 0 3 3 -1 4 4 1 2 2 0 3 3 -1 5 4 1 3 1
 -2 7 2 -2 6 5 1 1 1 0 3 3 -1 6 5 1 2 2 0 3 3 -1 7 5 1 3 1 0 3 4 -1 6 5 1 4 2 0
 3 4 -1 7 5 1 5
 7 5 14 607 1 0 1 2 0 0
 1 1 2 2 1 1 1 1 3 3 1 1 2 1 3 3 1 2 1 1 4 4 1 1 2 1 4 4 1 2 1 1 5 5 1 1 2 1 5 5
 1 2
 1 9 20 621 3 1 0 5 3 0
 0 0 9 0 2 9 0 -2 7 0 2 4 0 0 9 0 2 8 0 -2 6 0 2 3 0 -2 9 0 -2 8 0 1 5 0 -1 2 0
 2 7 0 2 6 0 -1 5 0 1 1 0 -2 4 0 -2 3 0 1 2 0 -1 1
 1 7 60 641 2 0 0 5 3 0
 0 0 7 0 0 7 0 0 7 0 0 7 0 -2 7 0 2 5 0 0 7 0 2 7 0 -2 3 0 0 7 0 -2 5 0 2 3 0 0
 7 0 0 7 0 0 7 0 0 7 0 -2 6 0 2 4 0 0 7 0 2 6 0 -2 2 0 0 7 0 -2 4 0 2 2 0 0 7 0
 2 7 0 -2 5 0 0 7 0 2 6 0 -2 4 0 -2 7 0 -2 6 0 1 1 0 2 5 0 2 4 0 -1 1 0 0 7 0 -2
 7 0 2 3 0 0 7 0 -2 6 0 2 2 0 2 7 0 2 6 0 -1 1 0 -2 3 0 -2 2 0 1 1 0 0 7 0 2 5 0
 -2 3 0 0 7 0 2 4 0 -2 2 0 -2 5 0 -2 4 0 1 1 0 2 3 0 2 2 0 -1 1
 1 5 5 701 4 2 0 5 3 0
 1 1 5 2 1 4 3 -2 3 4 2 2 5 -2 1
 0 0 0 0 0 0 0 0 0 0
 0 0 0 0 0 0 0 0 0 0
