 4 2 1 0 1 2 3 4
 1 4 4 1 3 2 1 4 2 0
 1 1 4 2 1 3 3 2 2 4 -2 1
 4 10 12 5 2 1 1 3 2 1
 1 -1 5 2 -1 3 3 1 1 1 -1 9 2 -1 7 4 1 1 1 -2 10 3 1 6 4 -1 2 2 -2 10 3 1 8 4 -1
 4
 10 4 20 17 1 0 1 2 1 1
 1 1 2 2 1 1 1 -2 3 3 1 1 1 0 2 3 1 1 2 -2 3 3 1 2 2 0 2 3 1 2 1 -2 4 4 1 1 1 0
 2 4 1 1 2 -2 4 4 1 2 2 0 2 4 1 2 3 -1 4 4 1 3
 4 1 4 37 0 0 0 1 0 1
 1 1 1 2 1 1 3 1 1 4 1 1
 1 10 12 41 2 1 1 4 2 0
 0 -2 10 0 -2 9 0 2 5 0 -2 10 0 -2 7 0 2 3 0 1 8 0 1 6 0 -2 1 0 -1 4 0 -1 2 0 2
 1
 1 4 24 53 1 0 1 4 2 0
 0 0 4 0 0 4 0 2 4 0 2 2 0 -2 3 0 -2 2 0 0 4 0 0 4 0 2 4 0 2 1 0 -2 3 0 -2 1 0 -2
 4 0 -2 2 0 -2 4 0 -2 1 0 1 2 0 1 1 0 2 3 0 2 2 0 2 3 0 2 1 0 -1 2 0 -1 1
 1 5 12 77 2 2 0 4 2 0
 0 1 5 0 -2 4 0 2 2 0 1 5 0 -2 3 0 2 1 0 -2 4 0 -2 3 0 0 5 0 2 2 0 2 1 0 0 5
 5 4 10 89 1 1 0 2 2 0
 1 1 3 3 -1 1 2 1 3 3 -1 2 1 1 4 4 -1 1 2 1 4 4 -1 2 3 1 4 4 -1 3
 4 1 4 99 0 0 0 1 1 0
 1 1 1 2 1 1 3 1 1 4 1 1
 1 4 24 103 1 1 0 4 2 0
 0 -2 4 0 2 3 0 -2 4 0 0 4 0 2 3 0 0 4 0 -2 4 0 2 3 0 -2 4 0 0 4 0 2 3 0 0 4 0 1
 4 0 -2 2 0 1 4 0 -2 1 0 -2 2 0 -2 1 0 -1 3 0 2 2 0 -1 3 0 2 1 0 2 2 0 2 1
 1 4 4 127 3 1 0 4 2 0
 1 -2 4 2 -2 3 3 1 2 4 -1 1
 4 5 12 131 2 0 0 3 1 0
 1 -2 3 2 -2 2 3 1 1 1 -2 5 2 -2 4 4 1 1 1 0 3 3 -1 4 4 1 2 2 0 3 3 -1 5 4 1 3
 5 4 10 143 1 0 1 2 0 0
 1 1 2 2 1 1 1 1 3 3 1 1 2 1 3 3 1 2 1 1 4 4 1 1 2 1 4 4 1 2
 1 5 12 153 2 0 0 4 2 0
 0 0 5 0 2 5 0 -2 3 0 0 5 0 2 4 0 -2 2 0 -2 5 0 -2 4 0 1 1 0 2 3 0 2 2 0 -1 1
 1 4 4 165 3 1 0 4 2 0
 1 1 4 2 1 3 3 2 2 4 -2 1
 1 1 24 169 0 0 0 4 2 0
 0 0 1 0 0 1 0 2 1 0 2 1 0 -2 1 0 -2 1 0 0 1 0 0 1 0 2 1 0 2 1 0 -2 1 0 -2 1 0 -2
 1 0 -2 1 0 -2 1 0 -2 1 0 1 1 0 1 1 0 2 1 0 2 1 0 2 1 0 2 1 0 -1 1 0 -1 1
 0 0 0 0 0 0 0 0 0 0
 0 0 0 0 0 0 0 0 0 0
