 6 6 1 0 1 2 3 4 5 6
 1 6 6 1 5 5 0 6 6 0
 1 1 6 2 -1 5 3 1 4 4 -1 3 5 1 2 6 -1 1
 6 15 30 7 4 4 0 5 5 0
 1 1 5 2 -1 4 3 1 3 4 -1 2 5 1 1 1 1 9 2 -1 8 3 1 7 4 -1 6 6 1 1 1 1 12 2 -1 11
 3 1 10 5 -1 6 6 1 2 1 1 14 2 -1 13 4 1 10 5 -1 7 6 1 3 1 1 15 3 -1 13 4 1 11 5
 -1 8 6 1 4 2 1 15 3 -1 14 4 1 12 5 -1 9 6 1 5
 15 20 60 37 3 3 0 4 4 0
 1 1 4 2 -1 3 3 1 2 4 -1 1 1 1 7 2 -1 6 3 1 5 5 -1 1 1 1 9 2 -1 8 4 1 5 5 -1 2 1
 1 10 3 -1 8 4 1 6 5 -1 3 2 1 10 3 -1 9 4 1 7 5 -1 4 1 1 13 2 -1 12 3 1 11 6 -1
 1 1 1 15 2 -1 14 4 1 11 6 -1 2 1 1 16 3 -1 14 4 1 12 6 -1 3 2 1 16 3 -1 15 4 1
 13 6 -1 4 1 1 18 2 -1 17 5 1 11 6 -1 5 1 1 19 3 -1 17 5 1 12 6 -1 6 2 1 19 3 -1
 18 5 1 13 6 -1 7 1 1 20 4 -1 17 5 1 14 6 -1 8 2 1 20 4 -1 18 5 1 15 6 -1 9 3 1
 20 4 -1 19 5 1 16 6 -1 10
 20 15 60 97 2 2 0 3 3 0
 1 1 3 2 -1 2 3 1 1 1 1 5 2 -1 4 4 1 1 1 1 6 3 -1 4 4 1 2 2 1 6 3 -1 5 4 1 3 1 1
 8 2 -1 7 5 1 1 1 1 9 3 -1 7 5 1 2 2 1 9 3 -1 8 5 1 3 1 1 10 4 -1 7 5 1 4 2 1 10
 4 -1 8 5 1 5 3 1 10 4 -1 9 5 1 6 1 1 12 2 -1 11 6 1 1 1 1 13 3 -1 11 6 1 2 2 1
 13 3 -1 12 6 1 3 1 1 14 4 -1 11 6 1 4 2 1 14 4 -1 12 6 1 5 3 1 14 4 -1 13 6 1 6
 1 1 15 5 -1 11 6 1 7 2 1 15 5 -1 12 6 1 8 3 1 15 5 -1 13 6 1 9 4 1 15 5 -1 14 6
 1 10
 15 6 30 157 1 1 0 2 2 0
 1 1 2 2 -1 1 1 1 3 3 -1 1 2 1 3 3 -1 2 1 1 4 4 -1 1 2 1 4 4 -1 2 3 1 4 4 -1 3 1
 1 5 5 -1 1 2 1 5 5 -1 2 3 1 5 5 -1 3 4 1 5 5 -1 4 1 1 6 6 -1 1 2 1 6 6 -1 2 3 1
 6 6 -1 3 4 1 6 6 -1 4 5 1 6 6 -1 5
 6 1 6 187 0 0 0 1 1 0
 1 1 1 2 1 1 3 1 1 4 1 1 5 1 1 6 1 1
 1 6 6 193 5 5 0 6 6 0
 1 1 6 2 -1 5 3 1 4 4 -1 3 5 1 2 6 -1 1
 1 15 30 199 4 4 0 6 6 0
 0 1 15 0 -1 14 0 1 12 0 -1 9 0 1 5 0 -1 15 0 1 13 0 -1 11 0 1 8 0 -1 4 0 1 14 0
 -1 13 0 1 10 0 -1 7 0 1 3 0 -1 12 0 1 11 0 -1 10 0 1 6 0 -1 2 0 1 9 0 -1 8 0 1
 7 0 -1 6 0 1 1 0 -1 5 0 1 4 0 -1 3 0 1 2 0 -1 1
 1 20 120 229 3 3 0 6 6 0
 0 1 20 0 -1 19 0 1 16 0 -1 10 0 -1 20 0 1 18 0 -1 15 0 1 9 0 1 19 0 -1 18 0 1
 13 0 -1 7 0 -1 16 0 1 15 0 -1 13 0 1 4 0 1 10 0 -1 9 0 1 7 0 -1 4 0 -1 20 0 1
 19 0 -1 16 0 1 10 0 1 20 0 -1 17 0 1 14 0 -1 8 0 -1 19 0 1 17 0 -1 12 0 1 6 0 1
 16 0 -1 14 0 1 12 0 -1 3 0 -1 10 0 1 8 0 -1 6 0 1 3 0 1 20 0 -1 18 0 1 15 0 -1
 9 0 -1 20 0 1 17 0 -1 14 0 1 8 0 1 18 0 -1 17 0 1 11 0 -1 5 0 -1 15 0 1 14 0 -1
 11 0 1 2 0 1 9 0 -1 8 0 1 5 0 -1 2 0 -1 19 0 1 18 0 -1 13 0 1 7 0 1 19 0 -1 17
 0 1 12 0 -1 6 0 -1 18 0 1 17 0 -1 11 0 1 5 0 1 13 0 -1 12 0 1 11 0 -1 1 0 -1 7
 0 1 6 0 -1 5 0 1 1 0 1 16 0 -1 15 0 1 13 0 -1 4 0 -1 16 0 1 14 0 -1 12 0 1 3 0
 1 15 0 -1 14 0 1 11 0 -1 2 0 -1 13 0 1 12 0 -1 11 0 1 1 0 1 4 0 -1 3 0 1 2 0 -1
 1 0 -1 10 0 1 9 0 -1 7 0 1 4 0 1 10 0 -1 8 0 1 6 0 -1 3 0 -1 9 0 1 8 0 -1 5 0 1
 2 0 1 7 0 -1 6 0 1 5 0 -1 1 0 -1 4 0 1 3 0 -1 2 0 1 1
 1 15 360 349 2 2 0 6 6 0
 0 1 15 0 -1 14 0 1 10 0 -1 15 0 1 13 0 -1 9 0 1 14 0 -1 13 0 1 6 0 -1 10 0 1 9
 0 -1 6 0 -1 15 0 1 14 0 -1 10 0 1 15 0 -1 12 0 1 8 0 -1 14 0 1 12 0 -1 5 0 1 10
 0 -1 8 0 1 5 0 1 15 0 -1 13 0 1 9 0 -1 15 0 1 12 0 -1 8 0 1 13 0 -1 12 0 1 3 0
 -1 9 0 1 8 0 -1 3 0 -1 14 0 1 13 0 -1 6 0 1 14 0 -1 12 0 1 5 0 -1 13 0 1 12 0 -1
 3 0 1 6 0 -1 5 0 1 3 0 1 10 0 -1 9 0 1 6 0 -1 10 0 1 8 0 -1 5 0 1 9 0 -1 8 0 1
 3 0 -1 6 0 1 5 0 -1 3 0 -1 15 0 1 14 0 -1 10 0 1 15 0 -1 13 0 1 9 0 -1 14 0 1
 13 0 -1 6 0 1 10 0 -1 9 0 1 6 0 1 15 0 -1 14 0 1 10 0 -1 15 0 1 11 0 -1 7 0 1
 14 0 -1 11 0 1 4 0 -1 10 0 1 7 0 -1 4 0 -1 15 0 1 13 0 -1 9 0 1 15 0 -1 11 0 1
 7 0 -1 13 0 1 11 0 -1 2 0 1 9 0 -1 7 0 1 2 0 1 14 0 -1 13 0 1 6 0 -1 14 0 1 11
 0 -1 4 0 1 13 0 -1 11 0 1 2 0 -1 6 0 1 4 0 -1 2 0 -1 10 0 1 9 0 -1 6 0 1 10 0 -1
 7 0 1 4 0 -1 9 0 1 7 0 -1 2 0 1 6 0 -1 4 0 1 2 0 1 15 0 -1 14 0 1 10 0 -1 15 0
 1 12 0 -1 8 0 1 14 0 -1 12 0 1 5 0 -1 10 0 1 8 0 -1 5 0 -1 15 0 1 14 0 -1 10 0
 1 15 0 -1 11 0 1 7 0 -1 14 0 1 11 0 -1 4 0 1 10 0 -1 7 0 1 4 0 1 15 0 -1 12 0 1
 8 0 -1 15 0 1 11 0 -1 7 0 1 12 0 -1 11 0 1 1 0 -1 8 0 1 7 0 -1 1 0 -1 14 0 1 12
 0 -1 5 0 1 14 0 -1 11 0 1 4 0 -1 12 0 1 11 0 -1 1 0 1 5 0 -1 4 0 1 1 0 1 10 0 -1
 8 0 1 5 0 -1 10 0 1 7 0 -1 4 0 1 8 0 -1 7 0 1 1 0 -1 5 0 1 4 0 -1 1 0 -1 15 0 1
 13 0 -1 9 0 1 15 0 -1 12 0 1 8 0 -1 13 0 1 12 0 -1 3 0 1 9 0 -1 8 0 1 3 0 1 15
 0 -1 13 0 1 9 0 -1 15 0 1 11 0 -1 7 0 1 13 0 -1 11 0 1 2 0 -1 9 0 1 7 0 -1 2 0
 -1 15 0 1 12 0 -1 8 0 1 15 0 -1 11 0 1 7 0 -1 12 0 1 11 0 -1 1 0 1 8 0 -1 7 0 1
 1 0 1 13 0 -1 12 0 1 3 0 -1 13 0 1 11 0 -1 2 0 1 12 0 -1 11 0 1 1 0 -1 3 0 1 2
 0 -1 1 0 -1 9 0 1 8 0 -1 3 0 1 9 0 -1 7 0 1 2 0 -1 8 0 1 7 0 -1 1 0 1 3 0 -1 2
 0 1 1 0 1 14 0 -1 13 0 1 6 0 -1 14 0 1 12 0 -1 5 0 1 13 0 -1 12 0 1 3 0 -1 6 0
 1 5 0 -1 3 0 -1 14 0 1 13 0 -1 6 0 1 14 0 -1 11 0 1 4 0 -1 13 0 1 11 0 -1 2 0 1
 6 0 -1 4 0 1 2 0 1 14 0 -1 12 0 1 5 0 -1 14 0 1 11 0 -1 4 0 1 12 0 -1 11 0 1 1
 0 -1 5 0 1 4 0 -1 1 0 -1 13 0 1 12 0 -1 3 0 1 13 0 -1 11 0 1 2 0 -1 12 0 1 11 0
 -1 1 0 1 3 0 -1 2 0 1 1 0 1 6 0 -1 5 0 1 3 0 -1 6 0 1 4 0 -1 2 0 1 5 0 -1 4 0 1
 1 0 -1 3 0 1 2 0 -1 1 0 -1 10 0 1 9 0 -1 6 0 1 10 0 -1 8 0 1 5 0 -1 9 0 1 8 0 -1
 3 0 1 6 0 -1 5 0 1 3 0 1 10 0 -1 9 0 1 6 0 -1 10 0 1 7 0 -1 4 0 1 9 0 -1 7 0 1
 2 0 -1 6 0 1 4 0 -1 2 0 -1 10 0 1 8 0 -1 5 0 1 10 0 -1 7 0 1 4 0 -1 8 0 1 7 0 -1
 1 0 1 5 0 -1 4 0 1 1 0 1 9 0 -1 8 0 1 3 0 -1 9 0 1 7 0 -1 2 0 1 8 0 -1 7 0 1 1
 0 -1 3 0 1 2 0 -1 1 0 -1 6 0 1 5 0 -1 3 0 1 6 0 -1 4 0 1 2 0 -1 5 0 1 4 0 -1 1
 0 1 3 0 -1 2 0 1 1
 0 0 0 0 0 0 0 0 0 0
 0 0 0 0 0 0 0 0 0 0
