 4 0 1 0 1 2 3 4
 1 10 12 1 2 0 2 4 0 0
 0 -2 10 0 1 9 0 1 4 0 -2 10 0 1 7 0 1 2 0 1 8 0 1 6 0 -2 1 0 1 5 0 1 3 0 -2 1
 10 4 20 13 1 0 1 2 0 2
 1 1 2 2 1 1 1 1 3 3 -2 1 1 -2 3 3 1 1 2 1 3 3 -2 2 2 -2 3 3 1 2 1 -2 4 4 1 1 1
 1 4 4 -2 1 2 -2 4 4 1 2 2 1 4 4 -2 2 3 1 4 4 1 3
 4 1 4 33 0 0 0 1 0 1
 1 1 1 2 1 1 3 1 1 4 1 1
 1 4 24 37 1 0 1 4 0 0
 0 -2 4 0 -2 3 0 -2 4 0 1 2 0 -2 3 0 1 2 0 -2 4 0 -2 3 0 -2 4 0 1 1 0 -2 3 0 1 1
 0 1 4 0 -2 2 0 1 4 0 -2 1 0 -2 2 0 -2 1 0 1 3 0 -2 2 0 1 3 0 -2 1 0 -2 2 0 -2 1
 1 4 4 61 3 0 1 4 0 0
 1 1 4 2 1 3 3 1 2 4 1 1
 4 6 12 65 2 0 0 3 0 1
 1 -2 3 2 -2 2 3 1 1 1 -2 5 2 -2 4 4 1 1 1 1 6 3 -2 4 4 -2 2 2 1 6 3 -2 5 4 -2 3
 6 4 12 77 1 0 1 2 0 0
 1 1 2 2 1 1 1 1 3 3 1 1 2 1 3 3 1 2 1 1 4 4 1 1 2 1 4 4 1 2 3 1 4 4 1 3
 1 4 4 89 3 0 1 4 0 0
 1 1 4 2 1 3 3 1 2 4 1 1
 1 6 12 93 2 0 0 4 0 0
 0 1 6 0 -2 5 0 -2 3 0 1 6 0 -2 4 0 -2 2 0 -2 5 0 -2 4 0 1 1 0 -2 3 0 -2 2 0 1 1
 1 1 24 105 0 0 0 4 0 0
 0 1 1 0 1 1 0 -2 1 0 -2 1 0 -2 1 0 -2 1 0 1 1 0 1 1 0 -2 1 0 -2 1 0 -2 1 0 -2 1
 0 -2 1 0 -2 1 0 -2 1 0 -2 1 0 1 1 0 1 1 0 -2 1 0 -2 1 0 -2 1 0 -2 1 0 1 1 0 1 1
 0 0 0 0 0 0 0 0 0 0
 0 0 0 0 0 0 0 0 0 0
