 5 5 1 0 1 2 3 4 5
 1 5 5 1 4 4 0 5 5 0
 1 1 5 2 -1 4 3 1 3 4 -1 2 5 1 1
 5 10 20 6 3 3 0 4 4 0
 1 1 4 2 -1 3 3 1 2 4 -1 1 1 1 7 2 -1 6 3 1 5 5 -1 1 1 1 9 2 -1 8 4 1 5 5 -1 2 1
 1 10 3 -1 8 4 1 6 5 -1 3 2 1 10 3 -1 9 4 1 7 5 -1 4
 10 10 30 26 2 2 0 3 3 0
 1 1 3 2 -1 2 3 1 1 1 1 5 2 -1 4 4 1 1 1 1 6 3 -1 4 4 1 2 2 1 6 3 -1 5 4 1 3 1 1
 8 2 -1 7 5 1 1 1 1 9 3 -1 7 5 1 2 2 1 9 3 -1 8 5 1 3 1 1 10 4 -1 7 5 1 4 2 1 10
 4 -1 8 5 1 5 3 1 10 4 -1 9 5 1 6
 10 5 20 56 1 1 0 2 2 0
 1 1 2 2 -1 1 1 1 3 3 -1 1 2 1 3 3 -1 2 1 1 4 4 -1 1 2 1 4 4 -1 2 3 1 4 4 -1 3 1
 1 5 5 -1 1 2 1 5 5 -1 2 3 1 5 5 -1 3 4 1 5 5 -1 4
 5 1 5 76 0 0 0 1 1 0
 1 1 1 2 1 1 3 1 1 4 1 1 5 1 1
 1 5 5 81 4 4 0 5 5 0
 1 1 5 2 -1 4 3 1 3 4 -1 2 5 1 1
 1 10 20 86 3 3 0 5 5 0
 0 1 10 0 -1 9 0 1 7 0 -1 4 0 -1 10 0 1 8 0 -1 6 0 1 3 0 1 9 0 -1 8 0 1 5 0 -1 2
 0 -1 7 0 1 6 0 -1 5 0 1 1 0 1 4 0 -1 3 0 1 2 0 -1 1
 1 10 60 106 2 2 0 5 5 0
 0 1 10 0 -1 9 0 1 6 0 -1 10 0 1 8 0 -1 5 0 1 9 0 -1 8 0 1 3 0 -1 6 0 1 5 0 -1 3
 0 -1 10 0 1 9 0 -1 6 0 1 10 0 -1 7 0 1 4 0 -1 9 0 1 7 0 -1 2 0 1 6 0 -1 4 0 1 2
 0 1 10 0 -1 8 0 1 5 0 -1 10 0 1 7 0 -1 4 0 1 8 0 -1 7 0 1 1 0 -1 5 0 1 4 0 -1 1
 0 -1 9 0 1 8 0 -1 3 0 1 9 0 -1 7 0 1 2 0 -1 8 0 1 7 0 -1 1 0 1 3 0 -1 2 0 1 1 0
 1 6 0 -1 5 0 1 3 0 -1 6 0 1 4 0 -1 2 0 1 5 0 -1 4 0 1 1 0 -1 3 0 1 2 0 -1 1
 1 5 120 166 1 1 0 5 5 0
 0 1 5 0 -1 4 0 -1 5 0 1 3 0 1 4 0 -1 3 0 -1 5 0 1 4 0 1 5 0 -1 2 0 -1 4 0 1 2 0
 1 5 0 -1 3 0 -1 5 0 1 2 0 1 3 0 -1 2 0 -1 4 0 1 3 0 1 4 0 -1 2 0 -1 3 0 1 2 0 -1
 5 0 1 4 0 1 5 0 -1 3 0 -1 4 0 1 3 0 1 5 0 -1 4 0 -1 5 0 1 1 0 1 4 0 -1 1 0 -1 5
 0 1 3 0 1 5 0 -1 1 0 -1 3 0 1 1 0 1 4 0 -1 3 0 -1 4 0 1 1 0 1 3 0 -1 1 0 1 5 0
 -1 4 0 -1 5 0 1 2 0 1 4 0 -1 2 0 -1 5 0 1 4 0 1 5 0 -1 1 0 -1 4 0 1 1 0 1 5 0 -1
 2 0 -1 5 0 1 1 0 1 2 0 -1 1 0 -1 4 0 1 2 0 1 4 0 -1 1 0 -1 2 0 1 1 0 -1 5 0 1 3
 0 1 5 0 -1 2 0 -1 3 0 1 2 0 1 5 0 -1 3 0 -1 5 0 1 1 0 1 3 0 -1 1 0 -1 5 0 1 2 0
 1 5 0 -1 1 0 -1 2 0 1 1 0 1 3 0 -1 2 0 -1 3 0 1 1 0 1 2 0 -1 1 0 1 4 0 -1 3 0 -1
 4 0 1 2 0 1 3 0 -1 2 0 -1 4 0 1 3 0 1 4 0 -1 1 0 -1 3 0 1 1 0 1 4 0 -1 2 0 -1 4
 0 1 1 0 1 2 0 -1 1 0 -1 3 0 1 2 0 1 3 0 -1 1 0 -1 2 0 1 1
 0 0 0 0 0 0 0 0 0 0
 0 0 0 0 0 0 0 0 0 0
