 3 1 1 0 1 2 3
 1 3 3 1 2 1 1 3 1 0
 1 1 3 2 1 2 3 -2 1
 3 3 6 4 1 0 1 2 1 1
 1 1 2 2 1 1 1 -2 3 3 1 1 2 -2 3 3 1 2
 3 1 3 10 0 0 0 1 0 1
 1 1 1 2 1 1 3 1 1
 1 3 6 13 1 0 1 3 1 0
 0 -2 3 0 -2 2 0 -2 3 0 -2 1 0 1 2 0 1 1
 1 3 6 19 1 1 0 3 1 0
 0 1 3 0 -2 2 0 1 3 0 -2 1 0 -2 2 0 -2 1
 3 1 3 25 0 0 0 1 1 0
 1 1 1 2 1 1 3 1 1
 1 3 3 28 2 0 0 3 1 0
 1 -2 3 2 -2 2 3 1 1
 3 3 6 31 1 0 1 2 0 0
 1 1 2 2 1 1 1 1 3 3 1 1 2 1 3 3 1 2
 1 3 3 37 2 0 0 3 1 0
 1 1 3 2 1 2 3 -2 1
 1 1 6 40 0 0 0 3 1 0
 0 -2 1 0 -2 1 0 -2 1 0 -2 1 0 1 1 0 1 1
 0 0 0 0 0 0 0 0 0 0
 0 0 0 0 0 0 0 0 0 0
