 6 0 1 0 1 2 3 4 5 6
 1 84 120 1 3 0 3 6 0 0
 0 -2 82 0 -2 79 0 -2 70 0 -2 40 0 -2 84 0 -2 77 0 1 69 0 1 37 0 -2 80 0 -2 77 0
 1 55 0 1 23 0 -2 71 0 1 65 0 1 54 0 -2 11 0 -2 42 0 1 39 0 1 27 0 -2 11 0 -2 82
 0 -2 79 0 -2 70 0 -2 40 0 -2 84 0 -2 75 0 1 63 0 1 31 0 -2 80 0 -2 75 0 1 49 0
 1 18 0 -2 71 0 1 59 0 1 47 0 -2 9 0 -2 42 0 1 32 0 1 20 0 -2 9 0 -2 83 0 -2 78
 0 1 68 0 1 36 0 -2 83 0 -2 74 0 1 60 0 1 29 0 -2 76 0 -2 73 0 -2 43 0 -2 13 0 1
 64 0 1 61 0 -2 44 0 -2 5 0 1 38 0 1 33 0 -2 15 0 -2 5 0 -2 81 0 -2 78 0 1 57 0
 1 25 0 -2 81 0 -2 74 0 1 50 0 1 19 0 -2 76 0 -2 73 0 -2 43 0 -2 13 0 1 53 0 1
 51 0 -2 44 0 -2 3 0 1 26 0 1 21 0 -2 15 0 -2 3 0 -2 72 0 1 66 0 1 56 0 -2 12 0
 -2 72 0 1 58 0 1 46 0 -2 8 0 1 67 0 1 62 0 -2 45 0 -2 6 0 1 52 0 1 48 0 -2 45 0
 -2 2 0 -2 10 0 -2 7 0 -2 4 0 -2 1 0 -2 41 0 1 34 0 1 24 0 -2 12 0 -2 41 0 1 28
 0 1 16 0 -2 8 0 1 35 0 1 30 0 -2 14 0 -2 6 0 1 22 0 1 17 0 -2 14 0 -2 2 0 -2 10
 0 -2 7 0 -2 4 0 -2 1
 84 39 252 121 2 0 2 3 0 3
 1 1 6 2 1 2 3 -2 1 1 1 5 2 1 3 3 -2 1 1 -2 7 2 -2 4 3 1 1 1 1 11 2 1 8 4 -2 1 1
 -2 13 2 -2 9 4 1 1 1 1 12 2 1 10 4 -2 1 1 -2 14 3 1 10 4 1 3 1 -2 14 3 1 8 4 1
 2 1 1 14 3 -2 9 4 -2 4 2 -2 14 3 1 12 4 1 5 2 1 14 3 -2 13 4 -2 7 2 -2 14 3 1
 11 4 1 6 1 1 18 2 1 15 5 -2 1 1 -2 20 2 -2 16 5 1 1 1 1 19 2 1 17 5 -2 1 1 -2
 22 3 -2 15 5 1 2 1 -2 21 3 -2 17 5 1 3 1 1 21 3 -2 15 5 -2 3 1 -2 21 3 1 15 5 -2
 2 1 1 22 3 -2 17 5 -2 2 1 -2 22 3 1 17 5 -2 3 2 -2 21 3 -2 19 5 1 5 2 1 21 3 -2
 18 5 -2 5 2 -2 22 3 -2 18 5 1 6 2 -2 21 3 1 18 5 -2 6 2 -2 22 3 1 19 5 -2 5 2 1
 22 3 -2 19 5 -2 6 1 -2 26 4 -2 15 5 1 8 1 -2 24 4 1 15 5 -2 8 1 -2 24 4 -2 17 5
 1 10 1 1 24 4 -2 15 5 -2 10 1 1 26 4 -2 17 5 -2 8 1 -2 26 4 1 17 5 -2 10 2 -2
 26 4 -2 18 5 1 11 2 -2 24 4 -2 19 5 1 12 2 -2 24 4 1 18 5 -2 11 2 1 24 4 -2 18
 5 -2 12 2 -2 26 4 1 19 5 -2 12 2 1 26 4 -2 19 5 -2 11 3 1 24 4 1 21 5 -2 14 3 -2
 25 4 -2 23 5 1 14 3 1 26 4 1 22 5 -2 14 1 1 31 2 1 27 6 -2 1 1 1 30 2 1 28 6 -2
 1 1 -2 32 2 -2 29 6 1 1 1 -2 33 3 -2 27 6 1 2 1 1 33 3 -2 28 6 -2 2 1 -2 34 3 -2
 28 6 1 3 1 1 34 3 -2 27 6 -2 3 1 -2 34 3 1 27 6 -2 2 1 -2 33 3 1 28 6 -2 3 2 -2
 34 3 -2 30 6 1 5 2 -2 33 3 1 30 6 -2 5 2 1 33 3 -2 30 6 -2 6 2 1 34 3 -2 31 6 -2
 5 2 -2 33 3 -2 31 6 1 6 2 -2 34 3 1 31 6 -2 6 1 -2 36 4 -2 27 6 1 8 1 1 36 4 -2
 28 6 -2 8 1 -2 38 4 1 27 6 -2 8 1 -2 36 4 1 28 6 -2 10 1 -2 38 4 -2 28 6 1 10 1
 1 38 4 -2 27 6 -2 10 2 -2 36 4 1 30 6 -2 12 2 1 36 4 -2 30 6 -2 11 2 -2 36 4 -2
 31 6 1 11 2 -2 38 4 -2 30 6 1 12 2 -2 38 4 1 31 6 -2 11 2 1 38 4 -2 31 6 -2 12
 3 1 38 4 1 34 6 -2 14 3 1 36 4 1 33 6 -2 14 3 -2 37 4 -2 35 6 1 14 1 -2 39 5 1
 28 6 1 17 1 -2 39 5 1 27 6 1 15 1 1 39 5 -2 29 6 -2 16 2 -2 39 5 1 30 6 1 19 2
 1 39 5 -2 32 6 -2 20 2 -2 39 5 1 31 6 1 18 3 -2 39 5 1 33 6 1 22 3 -2 39 5 1 34
 6 1 21 3 1 39 5 -2 35 6 -2 23 4 -2 39 5 1 36 6 1 26 4 1 39 5 -2 37 6 -2 25 4 -2
 39 5 1 38 6 1 24
 39 6 78 373 1 0 1 2 0 2
 1 1 2 2 1 1 1 1 3 3 -2 1 1 -2 3 3 1 1 1 1 3 3 1 1 2 -2 3 3 1 2 2 1 3 3 -2 2 2 1
 3 3 1 2 1 1 4 4 -2 1 1 1 4 4 1 1 1 -2 4 4 1 1 2 1 4 4 -2 2 2 -2 4 4 1 2 2 1 4 4
 1 2 3 1 4 4 1 3 1 1 5 5 -2 1 1 1 5 5 1 1 1 -2 5 5 1 1 2 1 5 5 -2 2 2 -2 5 5 1 2
 2 1 5 5 1 2 3 1 5 5 -2 3 3 -2 5 5 1 3 3 1 5 5 1 3 4 1 5 5 -2 4 4 1 5 5 1 4 4 -2
 5 5 1 4 1 1 6 6 -2 1 1 -2 6 6 1 1 1 1 6 6 1 1 2 -2 6 6 1 2 2 1 6 6 -2 2 2 1 6 6
 1 2 3 -2 6 6 1 3 3 1 6 6 -2 3 3 1 6 6 1 3 4 -2 6 6 1 4 4 1 6 6 1 4 4 1 6 6 -2 4
 5 1 6 6 1 5
 6 1 6 451 0 0 0 1 0 1
 1 1 1 2 1 1 3 1 1 4 1 1 5 1 1 6 1 1
 1 39 360 457 2 0 2 6 0 0
 0 -2 39 0 4 37 0 4 25 0 -2 39 0 4 35 0 4 23 0 4 37 0 4 35 0 -2 14 0 4 25 0 4 23
 0 -2 14 0 4 39 0 -2 36 0 -2 26 0 4 39 0 -2 31 0 -2 18 0 -2 36 0 -2 31 0 1 11 0
 -2 26 0 -2 18 0 1 11 0 4 39 0 -2 33 0 -2 22 0 4 39 0 -2 31 0 -2 18 0 -2 33 0 -2
 31 0 1 6 0 -2 22 0 -2 18 0 1 6 0 -2 38 0 -2 34 0 4 14 0 -2 38 0 1 31 0 -2 11 0
 -2 34 0 1 31 0 -2 6 0 4 14 0 -2 11 0 -2 6 0 -2 24 0 -2 21 0 4 14 0 -2 24 0 1 18
 0 -2 11 0 -2 21 0 1 18 0 -2 6 0 4 14 0 -2 11 0 -2 6 0 -2 39 0 4 37 0 4 25 0 -2
 39 0 4 35 0 4 23 0 4 37 0 4 35 0 -2 14 0 4 25 0 4 23 0 -2 14 0 4 39 0 -2 36 0 -2
 26 0 4 39 0 -2 27 0 -2 15 0 -2 36 0 -2 27 0 1 8 0 -2 26 0 -2 15 0 1 8 0 4 39 0
 -2 33 0 -2 22 0 4 39 0 -2 27 0 -2 15 0 -2 33 0 -2 27 0 1 2 0 -2 22 0 -2 15 0 1
 2 0 -2 38 0 -2 34 0 4 14 0 -2 38 0 1 27 0 -2 8 0 -2 34 0 1 27 0 -2 2 0 4 14 0 -2
 8 0 -2 2 0 -2 24 0 -2 21 0 4 14 0 -2 24 0 1 15 0 -2 8 0 -2 21 0 1 15 0 -2 2 0 4
 14 0 -2 8 0 -2 2 0 4 39 0 -2 38 0 -2 24 0 4 39 0 -2 30 0 -2 19 0 -2 38 0 -2 30
 0 1 12 0 -2 24 0 -2 19 0 1 12 0 4 39 0 -2 38 0 -2 24 0 4 39 0 -2 28 0 -2 17 0 -2
 38 0 -2 28 0 1 10 0 -2 24 0 -2 17 0 1 10 0 -2 39 0 4 32 0 4 20 0 -2 39 0 4 29 0
 4 16 0 4 32 0 4 29 0 -2 1 0 4 20 0 4 16 0 -2 1 0 1 38 0 -2 31 0 -2 12 0 1 38 0
 -2 27 0 -2 10 0 -2 31 0 -2 27 0 4 1 0 -2 12 0 -2 10 0 4 1 0 1 24 0 -2 18 0 -2
 12 0 1 24 0 -2 15 0 -2 10 0 -2 18 0 -2 15 0 4 1 0 -2 12 0 -2 10 0 4 1 0 4 39 0
 -2 34 0 -2 21 0 4 39 0 -2 30 0 -2 19 0 -2 34 0 -2 30 0 1 5 0 -2 21 0 -2 19 0 1
 5 0 4 39 0 -2 34 0 -2 21 0 4 39 0 -2 28 0 -2 17 0 -2 34 0 -2 28 0 1 3 0 -2 21 0
 -2 17 0 1 3 0 -2 39 0 4 32 0 4 20 0 -2 39 0 4 29 0 4 16 0 4 32 0 4 29 0 -2 1 0
 4 20 0 4 16 0 -2 1 0 1 34 0 -2 31 0 -2 5 0 1 34 0 -2 27 0 -2 3 0 -2 31 0 -2 27
 0 4 1 0 -2 5 0 -2 3 0 4 1 0 1 21 0 -2 18 0 -2 5 0 1 21 0 -2 15 0 -2 3 0 -2 18 0
 -2 15 0 4 1 0 -2 5 0 -2 3 0 4 1 0 -2 36 0 -2 33 0 4 14 0 -2 36 0 1 30 0 -2 12 0
 -2 33 0 1 30 0 -2 5 0 4 14 0 -2 12 0 -2 5 0 -2 36 0 -2 33 0 4 14 0 -2 36 0 1 28
 0 -2 10 0 -2 33 0 1 28 0 -2 3 0 4 14 0 -2 10 0 -2 3 0 1 36 0 -2 30 0 -2 11 0 1
 36 0 -2 28 0 -2 8 0 -2 30 0 -2 28 0 4 1 0 -2 11 0 -2 8 0 4 1 0 1 33 0 -2 30 0 -2
 6 0 1 33 0 -2 28 0 -2 2 0 -2 30 0 -2 28 0 4 1 0 -2 6 0 -2 2 0 4 1 0 -2 14 0 4
 13 0 4 7 0 -2 14 0 4 9 0 4 4 0 4 13 0 4 9 0 -2 1 0 4 7 0 4 4 0 -2 1 0 -2 26 0 -2
 22 0 4 14 0 -2 26 0 1 19 0 -2 12 0 -2 22 0 1 19 0 -2 5 0 4 14 0 -2 12 0 -2 5 0
 -2 26 0 -2 22 0 4 14 0 -2 26 0 1 17 0 -2 10 0 -2 22 0 1 17 0 -2 3 0 4 14 0 -2
 10 0 -2 3 0 1 26 0 -2 19 0 -2 11 0 1 26 0 -2 17 0 -2 8 0 -2 19 0 -2 17 0 4 1 0
 -2 11 0 -2 8 0 4 1 0 1 22 0 -2 19 0 -2 6 0 1 22 0 -2 17 0 -2 2 0 -2 19 0 -2 17
 0 4 1 0 -2 6 0 -2 2 0 4 1 0 -2 14 0 4 13 0 4 7 0 -2 14 0 4 9 0 4 4 0 4 13 0 4 9
 0 -2 1 0 4 7 0 4 4 0 -2 1
 1 27 30 817 4 0 2 6 0 0
 0 -2 27 0 1 26 0 1 21 0 1 16 0 1 9 0 -2 27 0 1 24 0 1 19 0 1 15 0 1 7 0 1 25 0
 1 23 0 -2 18 0 1 12 0 1 5 0 1 22 0 1 20 0 -2 18 0 1 11 0 1 3 0 1 17 0 1 14 0 1
 13 0 1 10 0 -2 1 0 1 8 0 1 6 0 1 4 0 1 2 0 -2 1
 27 36 108 847 3 0 1 4 0 2
 1 1 4 2 1 3 3 1 2 4 1 1 1 -2 9 2 -2 6 3 -2 5 5 1 1 1 -2 10 2 -2 8 3 1 5 5 -2 1
 1 -2 17 2 -2 13 4 -2 5 5 1 2 1 -2 16 2 -2 14 4 1 5 5 -2 2 1 -2 18 3 -2 12 4 -2
 7 5 1 3 1 1 18 3 -2 14 4 -2 8 5 -2 3 2 -2 18 3 -2 15 4 -2 11 5 1 4 2 1 18 3 -2
 16 4 -2 10 5 -2 4 1 -2 24 2 -2 20 3 -2 19 6 1 1 1 -2 23 2 -2 21 3 1 19 6 -2 1 1
 -2 30 2 -2 27 4 1 19 6 -2 2 1 -2 31 2 -2 28 4 -2 19 6 1 2 1 -2 32 3 -2 26 4 -2
 22 6 1 3 1 1 32 3 -2 27 4 -2 21 6 -2 3 2 1 32 3 -2 30 4 -2 23 6 -2 4 2 -2 32 3
 -2 29 4 -2 25 6 1 4 1 1 34 2 1 33 5 1 19 6 1 5 1 1 35 3 -2 33 5 -2 20 6 -2 6 1
 -2 35 3 1 33 5 -2 22 6 -2 7 2 1 35 3 -2 34 5 -2 24 6 -2 9 2 -2 35 3 1 34 5 -2
 25 6 -2 11 1 -2 36 4 1 33 5 -2 26 6 -2 12 1 1 36 4 -2 33 5 -2 28 6 -2 13 2 -2
 36 4 1 34 5 -2 29 6 -2 15 2 1 36 4 -2 34 5 -2 31 6 -2 17 3 1 36 4 1 35 5 1 32 6
 1 18
 36 15 108 955 2 0 0 3 0 1
 1 -2 3 2 -2 2 3 1 1 1 -2 5 2 -2 4 4 1 1 1 1 6 3 -2 4 4 -2 2 2 1 6 3 -2 5 4 -2 3
 1 -2 8 2 -2 7 5 1 1 1 -2 9 3 1 7 5 -2 2 1 1 9 3 -2 7 5 -2 2 1 -2 9 3 -2 7 5 1 2
 2 -2 9 3 1 8 5 -2 3 2 -2 9 3 -2 8 5 1 3 2 1 9 3 -2 8 5 -2 3 1 1 10 4 -2 7 5 -2
 4 1 -2 10 4 1 7 5 -2 4 1 -2 10 4 -2 7 5 1 4 2 1 10 4 -2 8 5 -2 5 2 -2 10 4 -2 8
 5 1 5 2 -2 10 4 1 8 5 -2 5 3 -2 10 4 -2 9 5 1 6 1 -2 12 2 -2 11 6 1 1 1 -2 13 3
 1 11 6 -2 2 1 -2 13 3 -2 11 6 1 2 1 1 13 3 -2 11 6 -2 2 2 -2 13 3 -2 12 6 1 3 2
 -2 13 3 1 12 6 -2 3 2 1 13 3 -2 12 6 -2 3 1 1 14 4 -2 11 6 -2 4 1 -2 14 4 -2 11
 6 1 4 1 -2 14 4 1 11 6 -2 4 2 1 14 4 -2 12 6 -2 5 2 -2 14 4 -2 12 6 1 5 2 -2 14
 4 1 12 6 -2 5 3 -2 14 4 -2 13 6 1 6 1 1 15 5 -2 11 6 -2 7 2 1 15 5 -2 12 6 -2 8
 3 1 15 5 -2 13 6 -2 9 4 1 15 5 -2 14 6 -2 10
 15 6 30 1063 1 0 1 2 0 0
 1 1 2 2 1 1 1 1 3 3 1 1 2 1 3 3 1 2 1 1 4 4 1 1 2 1 4 4 1 2 3 1 4 4 1 3 1 1 5 5
 1 1 2 1 5 5 1 2 3 1 5 5 1 3 4 1 5 5 1 4 1 1 6 6 1 1 2 1 6 6 1 2 3 1 6 6 1 3 4 1
 6 6 1 4 5 1 6 6 1 5
 1 36 120 1093 3 0 1 6 0 0
 0 -2 36 0 -2 35 0 -2 32 0 -2 18 0 -2 36 0 1 34 0 -2 29 0 -2 15 0 -2 35 0 1 34 0
 -2 25 0 -2 11 0 -2 32 0 -2 29 0 -2 25 0 1 4 0 -2 18 0 -2 15 0 -2 11 0 1 4 0 -2
 36 0 -2 35 0 -2 32 0 -2 18 0 -2 36 0 1 33 0 -2 26 0 -2 12 0 -2 35 0 1 33 0 -2
 22 0 -2 7 0 -2 32 0 -2 26 0 -2 22 0 1 3 0 -2 18 0 -2 12 0 -2 7 0 1 3 0 1 36 0 -2
 34 0 -2 31 0 -2 17 0 1 36 0 -2 33 0 -2 28 0 -2 13 0 -2 34 0 -2 33 0 -2 19 0 -2
 5 0 -2 31 0 -2 28 0 -2 19 0 1 2 0 -2 17 0 -2 13 0 -2 5 0 1 2 0 1 35 0 -2 34 0 -2
 24 0 -2 9 0 1 35 0 -2 33 0 -2 20 0 -2 6 0 -2 34 0 -2 33 0 -2 19 0 -2 5 0 -2 24
 0 -2 20 0 -2 19 0 1 1 0 -2 9 0 -2 6 0 -2 5 0 1 1 0 1 32 0 -2 30 0 -2 23 0 -2 4
 0 1 32 0 -2 27 0 -2 21 0 -2 3 0 -2 30 0 -2 27 0 1 19 0 -2 2 0 -2 23 0 -2 21 0 1
 19 0 -2 1 0 -2 4 0 -2 3 0 -2 2 0 -2 1 0 1 18 0 -2 16 0 -2 10 0 -2 4 0 1 18 0 -2
 14 0 -2 8 0 -2 3 0 -2 16 0 -2 14 0 1 5 0 -2 2 0 -2 10 0 -2 8 0 1 5 0 -2 1 0 -2
 4 0 -2 3 0 -2 2 0 -2 1
 1 6 6 1213 5 0 1 6 0 0
 1 1 6 2 1 5 3 1 4 4 1 3 5 1 2 6 1 1
 6 15 30 1219 4 0 0 5 0 1
 1 -2 5 2 -2 4 3 -2 3 4 -2 2 5 1 1 1 -2 9 2 -2 8 3 -2 7 4 -2 6 6 1 1 1 -2 12 2 -2
 11 3 1 10 5 -2 6 6 -2 2 1 -2 14 2 -2 13 4 1 10 5 -2 7 6 -2 3 1 1 15 3 -2 13 4 -2
 11 5 -2 8 6 -2 4 2 1 15 3 -2 14 4 -2 12 5 -2 9 6 -2 5
 15 36 60 1249 3 0 1 4 0 0
 1 1 4 2 1 3 3 1 2 4 1 1 1 1 11 2 1 7 3 1 5 5 1 1 1 1 15 2 1 12 4 1 5 5 1 2 1 1
 18 3 1 13 4 1 6 5 1 3 2 1 18 3 1 17 4 1 9 5 1 4 1 1 25 2 1 22 3 1 19 6 1 1 1 1
 29 2 1 26 4 1 19 6 1 2 1 1 32 3 1 28 4 1 20 6 1 3 2 1 32 3 1 31 4 1 24 6 1 4 1
 1 34 2 1 33 5 1 19 6 1 5 1 1 35 3 1 33 5 1 21 6 1 8 2 1 35 3 1 34 5 1 23 6 1 10
 1 1 36 4 1 33 5 1 27 6 1 14 2 1 36 4 1 34 5 1 30 6 1 16 3 1 36 4 1 35 5 1 32 6
 1 18
 1 6 6 1309 5 0 1 6 0 0
 1 1 6 2 1 5 3 1 4 4 1 3 5 1 2 6 1 1
 1 15 30 1315 4 0 0 6 0 0
 0 1 15 0 -2 14 0 -2 12 0 -2 9 0 -2 5 0 1 15 0 -2 13 0 -2 11 0 -2 8 0 -2 4 0 -2
 14 0 -2 13 0 1 10 0 -2 7 0 -2 3 0 -2 12 0 -2 11 0 1 10 0 -2 6 0 -2 2 0 -2 9 0 -2
 8 0 -2 7 0 -2 6 0 1 1 0 -2 5 0 -2 4 0 -2 3 0 -2 2 0 1 1
 1 15 360 1345 2 0 0 6 0 0
 0 1 15 0 -2 14 0 -2 10 0 1 15 0 -2 13 0 -2 9 0 -2 14 0 -2 13 0 1 6 0 -2 10 0 -2
 9 0 1 6 0 -2 15 0 4 14 0 4 10 0 -2 15 0 4 12 0 4 8 0 4 14 0 4 12 0 -2 5 0 4 10
 0 4 8 0 -2 5 0 -2 15 0 4 13 0 4 9 0 -2 15 0 4 12 0 4 8 0 4 13 0 4 12 0 -2 3 0 4
 9 0 4 8 0 -2 3 0 4 14 0 4 13 0 -2 6 0 4 14 0 -2 12 0 4 5 0 4 13 0 -2 12 0 4 3 0
 -2 6 0 4 5 0 4 3 0 4 10 0 4 9 0 -2 6 0 4 10 0 -2 8 0 4 5 0 4 9 0 -2 8 0 4 3 0 -2
 6 0 4 5 0 4 3 0 1 15 0 -2 14 0 -2 10 0 1 15 0 -2 13 0 -2 9 0 -2 14 0 -2 13 0 1
 6 0 -2 10 0 -2 9 0 1 6 0 -2 15 0 4 14 0 4 10 0 -2 15 0 4 11 0 4 7 0 4 14 0 4 11
 0 -2 4 0 4 10 0 4 7 0 -2 4 0 -2 15 0 4 13 0 4 9 0 -2 15 0 4 11 0 4 7 0 4 13 0 4
 11 0 -2 2 0 4 9 0 4 7 0 -2 2 0 4 14 0 4 13 0 -2 6 0 4 14 0 -2 11 0 4 4 0 4 13 0
 -2 11 0 4 2 0 -2 6 0 4 4 0 4 2 0 4 10 0 4 9 0 -2 6 0 4 10 0 -2 7 0 4 4 0 4 9 0
 -2 7 0 4 2 0 -2 6 0 4 4 0 4 2 0 -2 15 0 4 14 0 4 10 0 -2 15 0 4 12 0 4 8 0 4 14
 0 4 12 0 -2 5 0 4 10 0 4 8 0 -2 5 0 -2 15 0 4 14 0 4 10 0 -2 15 0 4 11 0 4 7 0
 4 14 0 4 11 0 -2 4 0 4 10 0 4 7 0 -2 4 0 1 15 0 -2 12 0 -2 8 0 1 15 0 -2 11 0 -2
 7 0 -2 12 0 -2 11 0 1 1 0 -2 8 0 -2 7 0 1 1 0 -2 14 0 4 12 0 4 5 0 -2 14 0 4 11
 0 4 4 0 4 12 0 4 11 0 -2 1 0 4 5 0 4 4 0 -2 1 0 -2 10 0 4 8 0 4 5 0 -2 10 0 4 7
 0 4 4 0 4 8 0 4 7 0 -2 1 0 4 5 0 4 4 0 -2 1 0 -2 15 0 4 13 0 4 9 0 -2 15 0 4 12
 0 4 8 0 4 13 0 4 12 0 -2 3 0 4 9 0 4 8 0 -2 3 0 -2 15 0 4 13 0 4 9 0 -2 15 0 4
 11 0 4 7 0 4 13 0 4 11 0 -2 2 0 4 9 0 4 7 0 -2 2 0 1 15 0 -2 12 0 -2 8 0 1 15 0
 -2 11 0 -2 7 0 -2 12 0 -2 11 0 1 1 0 -2 8 0 -2 7 0 1 1 0 -2 13 0 4 12 0 4 3 0 -2
 13 0 4 11 0 4 2 0 4 12 0 4 11 0 -2 1 0 4 3 0 4 2 0 -2 1 0 -2 9 0 4 8 0 4 3 0 -2
 9 0 4 7 0 4 2 0 4 8 0 4 7 0 -2 1 0 4 3 0 4 2 0 -2 1 0 4 14 0 4 13 0 -2 6 0 4 14
 0 -2 12 0 4 5 0 4 13 0 -2 12 0 4 3 0 -2 6 0 4 5 0 4 3 0 4 14 0 4 13 0 -2 6 0 4
 14 0 -2 11 0 4 4 0 4 13 0 -2 11 0 4 2 0 -2 6 0 4 4 0 4 2 0 -2 14 0 4 12 0 4 5 0
 -2 14 0 4 11 0 4 4 0 4 12 0 4 11 0 -2 1 0 4 5 0 4 4 0 -2 1 0 -2 13 0 4 12 0 4 3
 0 -2 13 0 4 11 0 4 2 0 4 12 0 4 11 0 -2 1 0 4 3 0 4 2 0 -2 1 0 1 6 0 -2 5 0 -2
 3 0 1 6 0 -2 4 0 -2 2 0 -2 5 0 -2 4 0 1 1 0 -2 3 0 -2 2 0 1 1 0 4 10 0 4 9 0 -2
 6 0 4 10 0 -2 8 0 4 5 0 4 9 0 -2 8 0 4 3 0 -2 6 0 4 5 0 4 3 0 4 10 0 4 9 0 -2 6
 0 4 10 0 -2 7 0 4 4 0 4 9 0 -2 7 0 4 2 0 -2 6 0 4 4 0 4 2 0 -2 10 0 4 8 0 4 5 0
 -2 10 0 4 7 0 4 4 0 4 8 0 4 7 0 -2 1 0 4 5 0 4 4 0 -2 1 0 -2 9 0 4 8 0 4 3 0 -2
 9 0 4 7 0 4 2 0 4 8 0 4 7 0 -2 1 0 4 3 0 4 2 0 -2 1 0 1 6 0 -2 5 0 -2 3 0 1 6 0
 -2 4 0 -2 2 0 -2 5 0 -2 4 0 1 1 0 -2 3 0 -2 2 0 1 1
 0 0 0 0 0 0 0 0 0 0
 0 0 0 0 0 0 0 0 0 0
