 6 4 1 0 1 2 3 4 5 6
 1 6 6 1 5 4 1 6 4 0
 1 1 6 2 1 5 3 2 4 4 -2 3 5 2 2 6 -2 1
 6 23 30 7 4 3 1 5 4 1
 1 -1 6 2 -1 5 3 1 3 4 -1 2 5 1 1 1 -1 12 2 -1 11 3 1 9 4 -1 8 6 1 1 1 -1 17 2 -1
 16 3 1 14 5 -1 8 6 1 2 1 -1 21 2 -1 20 4 1 14 5 -1 9 6 1 3 1 -2 23 3 1 19 4 -1
 15 5 1 10 6 -1 4 2 -2 23 3 1 22 4 -1 18 5 1 13 6 -1 7
 23 32 92 37 3 2 1 4 3 1
 1 -1 6 2 -1 4 3 1 2 4 -1 1 1 -1 11 2 -1 9 3 1 7 5 -1 1 1 -1 15 2 -1 13 4 1 7 5
 -1 2 1 -2 16 3 1 12 4 -1 8 5 1 3 1 0 6 3 -1 13 4 1 9 5 -1 4 2 0 6 3 -1 15 4 1
 11 5 -1 6 2 -2 16 3 1 14 4 -1 10 5 1 5 1 -1 21 2 -1 19 3 1 17 6 -1 1 1 -1 25 2
 -1 23 4 1 17 6 -1 2 1 -2 26 3 1 22 4 -1 18 6 1 3 1 0 6 3 -1 23 4 1 19 6 -1 4 2
 0 6 3 -1 25 4 1 21 6 -1 6 2 -2 26 3 1 24 4 -1 20 6 1 5 1 -1 30 2 -1 28 5 1 17 6
 -1 7 1 -2 31 3 1 27 5 -1 18 6 1 8 1 0 6 3 -1 28 5 1 19 6 -1 9 2 0 6 3 -1 30 5 1
 21 6 -1 11 2 -2 31 3 1 29 5 -1 20 6 1 10 1 -2 32 4 1 27 5 -1 22 6 1 12 1 0 6 4
 -1 28 5 1 23 6 -1 13 2 0 6 4 -1 30 5 1 25 6 -1 15 2 -2 32 4 1 29 5 -1 24 6 1 14
 3 -1 32 4 1 31 5 -1 26 6 1 16
 32 23 96 129 2 1 1 3 2 1
 1 -1 5 2 -1 3 3 1 1 1 -1 9 2 -1 7 4 1 1 1 -2 10 3 1 6 4 -1 2 1 0 5 3 -1 7 4 1 3
 2 -2 10 3 1 8 4 -1 4 2 0 5 3 -1 9 4 1 5 1 -1 14 2 -1 12 5 1 1 1 -2 15 3 1 11 5
 -1 2 1 0 5 3 -1 12 5 1 3 2 -2 15 3 1 13 5 -1 4 2 0 5 3 -1 14 5 1 5 1 -2 16 4 1
 11 5 -1 6 1 0 5 4 -1 12 5 1 7 2 -2 16 4 1 13 5 -1 8 2 0 5 4 -1 14 5 1 9 3 -1 16
 4 1 15 5 -1 10 1 -1 20 2 -1 18 6 1 1 1 -2 21 3 1 17 6 -1 2 1 0 5 3 -1 18 6 1 3
 2 -2 21 3 1 19 6 -1 4 2 0 5 3 -1 20 6 1 5 1 -2 22 4 1 17 6 -1 6 1 0 5 4 -1 18 6
 1 7 2 -2 22 4 1 19 6 -1 8 2 0 5 4 -1 20 6 1 9 3 -1 22 4 1 21 6 -1 10 1 -2 23 5
 1 17 6 -1 11 1 0 5 5 -1 18 6 1 12 2 -2 23 5 1 19 6 -1 13 2 0 5 5 -1 20 6 1 14 3
 -1 23 5 1 21 6 -1 15 4 -1 23 5 1 22 6 -1 16
 23 6 46 225 1 0 1 2 1 1
 1 1 2 2 1 1 1 -2 3 3 1 1 1 0 2 3 1 1 2 -2 3 3 1 2 2 0 2 3 1 2 1 -2 4 4 1 1 1 0
 2 4 1 1 2 -2 4 4 1 2 2 0 2 4 1 2 3 -1 4 4 1 3 1 -2 5 5 1 1 1 0 2 5 1 1 2 -2 5 5
 1 2 2 0 2 5 1 2 3 -1 5 5 1 3 4 -1 5 5 1 4 1 -2 6 6 1 1 1 0 2 6 1 1 2 -2 6 6 1 2
 2 0 2 6 1 2 3 -1 6 6 1 3 4 -1 6 6 1 4 5 -1 6 6 1 5
 6 1 6 271 0 0 0 1 0 1
 1 1 1 2 1 1 3 1 1 4 1 1 5 1 1 6 1 1
 1 23 30 277 4 3 1 6 4 0
 0 -2 23 0 -2 21 0 2 17 0 -2 12 0 2 6 0 -2 23 0 -2 20 0 2 16 0 -2 11 0 2 5 0 1
 22 0 1 19 0 -2 14 0 2 9 0 -2 3 0 -1 18 0 -1 15 0 2 14 0 -2 8 0 2 2 0 1 13 0 1
 10 0 -2 9 0 2 8 0 -2 1 0 -1 7 0 -1 4 0 2 3 0 -2 2 0 2 1
 1 32 120 307 3 2 1 6 4 0
 0 0 32 0 0 32 0 0 32 0 0 32 0 2 32 0 -2 30 0 2 25 0 -2 15 0 -2 31 0 2 30 0 -2
 21 0 2 11 0 2 26 0 -2 25 0 2 21 0 -2 6 0 -2 16 0 2 15 0 -2 11 0 2 6 0 0 32 0 0
 32 0 0 32 0 0 32 0 2 32 0 -2 28 0 2 23 0 -2 13 0 -2 31 0 2 28 0 -2 19 0 2 9 0 2
 26 0 -2 23 0 2 19 0 -2 4 0 -2 16 0 2 13 0 -2 9 0 2 4 0 -2 32 0 2 30 0 -2 25 0 2
 15 0 -2 32 0 2 28 0 -2 23 0 2 13 0 1 29 0 1 27 0 2 17 0 -2 7 0 -1 24 0 -1 22 0
 -2 17 0 2 2 0 1 14 0 1 12 0 2 7 0 -2 2 0 2 31 0 -2 30 0 2 21 0 -2 11 0 2 31 0 -2
 28 0 2 19 0 -2 9 0 -1 29 0 -1 27 0 -2 17 0 2 7 0 1 20 0 1 18 0 2 17 0 -2 1 0 -1
 10 0 -1 8 0 -2 7 0 2 1 0 -2 26 0 2 25 0 -2 21 0 2 6 0 -2 26 0 2 23 0 -2 19 0 2
 4 0 1 24 0 1 22 0 2 17 0 -2 2 0 -1 20 0 -1 18 0 -2 17 0 2 1 0 1 5 0 1 3 0 2 2 0
 -2 1 0 2 16 0 -2 15 0 2 11 0 -2 6 0 2 16 0 -2 13 0 2 9 0 -2 4 0 -1 14 0 -1 12 0
 -2 7 0 2 2 0 1 10 0 1 8 0 2 7 0 -2 1 0 -1 5 0 -1 3 0 -2 2 0 2 1
 1 23 360 427 2 1 1 6 4 0
 0 0 23 0 0 23 0 0 23 0 0 23 0 0 23 0 0 23 0 0 23 0 0 23 0 0 23 0 0 23 0 0 23 0
 0 23 0 0 23 0 0 23 0 0 23 0 -2 23 0 -2 20 0 2 14 0 2 22 0 2 20 0 -2 9 0 -2 16 0
 -2 14 0 2 9 0 0 23 0 0 23 0 0 23 0 2 23 0 2 20 0 -2 14 0 -2 21 0 -2 20 0 2 5 0
 2 15 0 2 14 0 -2 5 0 0 23 0 0 23 0 0 23 0 -2 22 0 -2 20 0 2 9 0 2 21 0 2 20 0 -2
 5 0 -2 10 0 -2 9 0 2 5 0 0 23 0 0 23 0 0 23 0 2 16 0 2 14 0 -2 9 0 -2 15 0 -2
 14 0 2 5 0 2 10 0 2 9 0 -2 5 0 0 23 0 0 23 0 0 23 0 0 23 0 0 23 0 0 23 0 0 23 0
 0 23 0 0 23 0 0 23 0 0 23 0 0 23 0 0 23 0 0 23 0 0 23 0 -2 23 0 -2 18 0 2 12 0
 2 22 0 2 18 0 -2 7 0 -2 16 0 -2 12 0 2 7 0 0 23 0 0 23 0 0 23 0 2 23 0 2 18 0 -2
 12 0 -2 21 0 -2 18 0 2 3 0 2 15 0 2 12 0 -2 3 0 0 23 0 0 23 0 0 23 0 -2 22 0 -2
 18 0 2 7 0 2 21 0 2 18 0 -2 3 0 -2 10 0 -2 7 0 2 3 0 0 23 0 0 23 0 0 23 0 2 16
 0 2 12 0 -2 7 0 -2 15 0 -2 12 0 2 3 0 2 10 0 2 7 0 -2 3 0 0 23 0 0 23 0 0 23 0
 2 23 0 2 20 0 -2 14 0 -2 22 0 -2 20 0 2 9 0 2 16 0 2 14 0 -2 9 0 0 23 0 0 23 0
 0 23 0 2 23 0 2 18 0 -2 12 0 -2 22 0 -2 18 0 2 7 0 2 16 0 2 12 0 -2 7 0 -2 23 0
 -2 20 0 2 14 0 -2 23 0 -2 18 0 2 12 0 1 19 0 1 17 0 -2 1 0 -1 13 0 -1 11 0 2 1
 0 2 22 0 2 20 0 -2 9 0 2 22 0 2 18 0 -2 7 0 -1 19 0 -1 17 0 2 1 0 1 8 0 1 6 0 -2
 1 0 -2 16 0 -2 14 0 2 9 0 -2 16 0 -2 12 0 2 7 0 1 13 0 1 11 0 -2 1 0 -1 8 0 -1
 6 0 2 1 0 0 23 0 0 23 0 0 23 0 -2 23 0 -2 20 0 2 14 0 2 21 0 2 20 0 -2 5 0 -2
 15 0 -2 14 0 2 5 0 0 23 0 0 23 0 0 23 0 -2 23 0 -2 18 0 2 12 0 2 21 0 2 18 0 -2
 3 0 -2 15 0 -2 12 0 2 3 0 2 23 0 2 20 0 -2 14 0 2 23 0 2 18 0 -2 12 0 -1 19 0 -1
 17 0 2 1 0 1 13 0 1 11 0 -2 1 0 -2 21 0 -2 20 0 2 5 0 -2 21 0 -2 18 0 2 3 0 1
 19 0 1 17 0 -2 1 0 -1 4 0 -1 2 0 2 1 0 2 15 0 2 14 0 -2 5 0 2 15 0 2 12 0 -2 3
 0 -1 13 0 -1 11 0 2 1 0 1 4 0 1 2 0 -2 1 0 0 23 0 0 23 0 0 23 0 2 22 0 2 20 0 -2
 9 0 -2 21 0 -2 20 0 2 5 0 2 10 0 2 9 0 -2 5 0 0 23 0 0 23 0 0 23 0 2 22 0 2 18
 0 -2 7 0 -2 21 0 -2 18 0 2 3 0 2 10 0 2 7 0 -2 3 0 -2 22 0 -2 20 0 2 9 0 -2 22
 0 -2 18 0 2 7 0 1 19 0 1 17 0 -2 1 0 -1 8 0 -1 6 0 2 1 0 2 21 0 2 20 0 -2 5 0 2
 21 0 2 18 0 -2 3 0 -1 19 0 -1 17 0 2 1 0 1 4 0 1 2 0 -2 1 0 -2 10 0 -2 9 0 2 5
 0 -2 10 0 -2 7 0 2 3 0 1 8 0 1 6 0 -2 1 0 -1 4 0 -1 2 0 2 1 0 0 23 0 0 23 0 0
 23 0 -2 16 0 -2 14 0 2 9 0 2 15 0 2 14 0 -2 5 0 -2 10 0 -2 9 0 2 5 0 0 23 0 0
 23 0 0 23 0 -2 16 0 -2 12 0 2 7 0 2 15 0 2 12 0 -2 3 0 -2 10 0 -2 7 0 2 3 0 2
 16 0 2 14 0 -2 9 0 2 16 0 2 12 0 -2 7 0 -1 13 0 -1 11 0 2 1 0 1 8 0 1 6 0 -2 1
 0 -2 15 0 -2 14 0 2 5 0 -2 15 0 -2 12 0 2 3 0 1 13 0 1 11 0 -2 1 0 -1 4 0 -1 2
 0 2 1 0 2 10 0 2 9 0 -2 5 0 2 10 0 2 7 0 -2 3 0 -1 8 0 -1 6 0 2 1 0 1 4 0 1 2 0
 -2 1
 1 9 30 787 4 4 0 6 4 0
 0 1 9 0 -2 8 0 2 6 0 -2 4 0 2 2 0 1 9 0 -2 7 0 2 5 0 -2 3 0 2 1 0 -2 8 0 -2 7 0
 0 9 0 0 9 0 0 9 0 2 6 0 2 5 0 0 9 0 0 9 0 0 9 0 -2 4 0 -2 3 0 0 9 0 0 9 0 0 9 0
 2 2 0 2 1 0 0 9 0 0 9 0 0 9
 9 16 36 817 3 3 0 4 4 0
 1 1 7 3 -1 5 4 1 3 5 -1 1 2 1 7 3 -1 6 4 1 4 5 -1 2 1 1 12 3 -1 10 4 1 8 6 -1 1
 2 1 12 3 -1 11 4 1 9 6 -1 2 1 1 15 3 -1 13 5 1 8 6 -1 3 2 1 15 3 -1 14 5 1 9 6
 -1 4 1 1 16 4 -1 13 5 1 10 6 -1 5 2 1 16 4 -1 14 5 1 11 6 -1 6 3 1 16 4 -1 15 5
 1 12 6 -1 7
 16 14 48 853 2 2 0 3 3 0
 1 1 5 3 -1 3 4 1 1 2 1 5 3 -1 4 4 1 2 1 1 8 3 -1 6 5 1 1 2 1 8 3 -1 7 5 1 2 1 1
 9 4 -1 6 5 1 3 2 1 9 4 -1 7 5 1 4 3 1 9 4 -1 8 5 1 5 1 1 12 3 -1 10 6 1 1 2 1
 12 3 -1 11 6 1 2 1 1 13 4 -1 10 6 1 3 2 1 13 4 -1 11 6 1 4 3 1 13 4 -1 12 6 1 5
 1 1 14 5 -1 10 6 1 6 2 1 14 5 -1 11 6 1 7 3 1 14 5 -1 12 6 1 8 4 1 14 5 -1 13 6
 1 9
 14 6 28 901 1 1 0 2 2 0
 1 1 3 3 -1 1 2 1 3 3 -1 2 1 1 4 4 -1 1 2 1 4 4 -1 2 3 1 4 4 -1 3 1 1 5 5 -1 1 2
 1 5 5 -1 2 3 1 5 5 -1 3 4 1 5 5 -1 4 1 1 6 6 -1 1 2 1 6 6 -1 2 3 1 6 6 -1 3 4 1
 6 6 -1 4 5 1 6 6 -1 5
 6 1 6 929 0 0 0 1 1 0
 1 1 1 2 1 1 3 1 1 4 1 1 5 1 1 6 1 1
 1 16 120 935 3 3 0 6 4 0
 0 -2 16 0 2 15 0 -2 12 0 2 7 0 -2 16 0 0 16 0 0 16 0 0 16 0 2 15 0 0 16 0 0 16
 0 0 16 0 -2 12 0 0 16 0 0 16 0 0 16 0 2 7 0 0 16 0 0 16 0 0 16 0 -2 16 0 2 15 0
 -2 12 0 2 7 0 -2 16 0 0 16 0 0 16 0 0 16 0 2 15 0 0 16 0 0 16 0 0 16 0 -2 12 0
 0 16 0 0 16 0 0 16 0 2 7 0 0 16 0 0 16 0 0 16 0 1 16 0 -2 14 0 2 11 0 -2 6 0 1
 16 0 -2 13 0 2 10 0 -2 5 0 -2 14 0 -2 13 0 0 16 0 0 16 0 2 11 0 2 10 0 0 16 0 0
 16 0 -2 6 0 -2 5 0 0 16 0 0 16 0 -1 15 0 2 14 0 -2 9 0 2 4 0 -1 15 0 2 13 0 -2
 8 0 2 3 0 2 14 0 2 13 0 0 16 0 0 16 0 -2 9 0 -2 8 0 0 16 0 0 16 0 2 4 0 2 3 0 0
 16 0 0 16 0 1 12 0 -2 11 0 2 9 0 -2 2 0 1 12 0 -2 10 0 2 8 0 -2 1 0 -2 11 0 -2
 10 0 0 16 0 0 16 0 2 9 0 2 8 0 0 16 0 0 16 0 -2 2 0 -2 1 0 0 16 0 0 16 0 -1 7 0
 2 6 0 -2 4 0 2 2 0 -1 7 0 2 5 0 -2 3 0 2 1 0 2 6 0 2 5 0 0 16 0 0 16 0 -2 4 0 -2
 3 0 0 16 0 0 16 0 2 2 0 2 1 0 0 16 0 0 16
 1 14 360 1055 2 2 0 6 4 0
 0 0 14 0 0 14 0 0 14 0 0 14 0 0 14 0 0 14 0 0 14 0 0 14 0 0 14 0 0 14 0 0 14 0
 0 14 0 2 14 0 -2 13 0 2 9 0 2 14 0 0 14 0 0 14 0 -2 13 0 0 14 0 0 14 0 2 9 0 0
 14 0 0 14 0 -2 14 0 2 12 0 -2 8 0 -2 14 0 0 14 0 0 14 0 2 12 0 0 14 0 0 14 0 -2
 8 0 0 14 0 0 14 0 2 13 0 -2 12 0 2 5 0 2 13 0 0 14 0 0 14 0 -2 12 0 0 14 0 0 14
 0 2 5 0 0 14 0 0 14 0 -2 9 0 2 8 0 -2 5 0 -2 9 0 0 14 0 0 14 0 2 8 0 0 14 0 0
 14 0 -2 5 0 0 14 0 0 14 0 0 14 0 0 14 0 0 14 0 0 14 0 0 14 0 0 14 0 0 14 0 0 14
 0 0 14 0 0 14 0 0 14 0 0 14 0 2 14 0 -2 13 0 2 9 0 2 14 0 0 14 0 0 14 0 -2 13 0
 0 14 0 0 14 0 2 9 0 0 14 0 0 14 0 -2 14 0 2 12 0 -2 8 0 -2 14 0 0 14 0 0 14 0 2
 12 0 0 14 0 0 14 0 -2 8 0 0 14 0 0 14 0 2 13 0 -2 12 0 2 5 0 2 13 0 0 14 0 0 14
 0 -2 12 0 0 14 0 0 14 0 2 5 0 0 14 0 0 14 0 -2 9 0 2 8 0 -2 5 0 -2 9 0 0 14 0 0
 14 0 2 8 0 0 14 0 0 14 0 -2 5 0 0 14 0 0 14 0 -2 14 0 2 13 0 -2 9 0 -2 14 0 0
 14 0 0 14 0 2 13 0 0 14 0 0 14 0 -2 9 0 0 14 0 0 14 0 -2 14 0 2 13 0 -2 9 0 -2
 14 0 0 14 0 0 14 0 2 13 0 0 14 0 0 14 0 -2 9 0 0 14 0 0 14 0 1 14 0 -2 11 0 2 7
 0 1 14 0 -2 10 0 2 6 0 -2 11 0 -2 10 0 0 14 0 2 7 0 2 6 0 0 14 0 -1 13 0 2 11 0
 -2 4 0 -1 13 0 2 10 0 -2 3 0 2 11 0 2 10 0 0 14 0 -2 4 0 -2 3 0 0 14 0 1 9 0 -2
 7 0 2 4 0 1 9 0 -2 6 0 2 3 0 -2 7 0 -2 6 0 0 14 0 2 4 0 2 3 0 0 14 0 2 14 0 -2
 12 0 2 8 0 2 14 0 0 14 0 0 14 0 -2 12 0 0 14 0 0 14 0 2 8 0 0 14 0 0 14 0 2 14
 0 -2 12 0 2 8 0 2 14 0 0 14 0 0 14 0 -2 12 0 0 14 0 0 14 0 2 8 0 0 14 0 0 14 0
 -1 14 0 2 11 0 -2 7 0 -1 14 0 2 10 0 -2 6 0 2 11 0 2 10 0 0 14 0 -2 7 0 -2 6 0
 0 14 0 1 12 0 -2 11 0 2 2 0 1 12 0 -2 10 0 2 1 0 -2 11 0 -2 10 0 0 14 0 2 2 0 2
 1 0 0 14 0 -1 8 0 2 7 0 -2 2 0 -1 8 0 2 6 0 -2 1 0 2 7 0 2 6 0 0 14 0 -2 2 0 -2
 1 0 0 14 0 -2 13 0 2 12 0 -2 5 0 -2 13 0 0 14 0 0 14 0 2 12 0 0 14 0 0 14 0 -2
 5 0 0 14 0 0 14 0 -2 13 0 2 12 0 -2 5 0 -2 13 0 0 14 0 0 14 0 2 12 0 0 14 0 0
 14 0 -2 5 0 0 14 0 0 14 0 1 13 0 -2 11 0 2 4 0 1 13 0 -2 10 0 2 3 0 -2 11 0 -2
 10 0 0 14 0 2 4 0 2 3 0 0 14 0 -1 12 0 2 11 0 -2 2 0 -1 12 0 2 10 0 -2 1 0 2 11
 0 2 10 0 0 14 0 -2 2 0 -2 1 0 0 14 0 1 5 0 -2 4 0 2 2 0 1 5 0 -2 3 0 2 1 0 -2 4
 0 -2 3 0 0 14 0 2 2 0 2 1 0 0 14 0 2 9 0 -2 8 0 2 5 0 2 9 0 0 14 0 0 14 0 -2 8
 0 0 14 0 0 14 0 2 5 0 0 14 0 0 14 0 2 9 0 -2 8 0 2 5 0 2 9 0 0 14 0 0 14 0 -2 8
 0 0 14 0 0 14 0 2 5 0 0 14 0 0 14 0 -1 9 0 2 7 0 -2 4 0 -1 9 0 2 6 0 -2 3 0 2 7
 0 2 6 0 0 14 0 -2 4 0 -2 3 0 0 14 0 1 8 0 -2 7 0 2 2 0 1 8 0 -2 6 0 2 1 0 -2 7
 0 -2 6 0 0 14 0 2 2 0 2 1 0 0 14 0 -1 5 0 2 4 0 -2 2 0 -1 5 0 2 3 0 -2 1 0 2 4
 0 2 3 0 0 14 0 -2 2 0 -2 1 0 0 14
 1 6 6 1415 5 3 0 6 4 0
 1 -2 6 2 -2 5 3 1 4 4 -1 3 5 1 2 6 -1 1
 6 14 30 1421 4 2 0 5 3 0
 1 -2 5 2 -2 4 3 1 3 4 -1 2 5 1 1 1 -2 9 2 -2 8 3 1 7 4 -1 6 6 1 1 1 -2 12 2 -2
 11 3 1 10 5 -1 6 6 1 2 1 -2 14 2 -2 13 4 1 10 5 -1 7 6 1 3 1 0 5 3 -1 13 4 1 11
 5 -1 8 6 1 4 2 0 5 3 -1 14 4 1 12 5 -1 9 6 1 5
 14 16 56 1451 3 1 0 4 2 0
 1 -2 4 2 -2 3 3 1 2 4 -1 1 1 -2 7 2 -2 6 3 1 5 5 -1 1 1 -2 9 2 -2 8 4 1 5 5 -1
 2 1 0 4 3 -1 8 4 1 6 5 -1 3 2 0 4 3 -1 9 4 1 7 5 -1 4 1 -2 12 2 -2 11 3 1 10 6
 -1 1 1 -2 14 2 -2 13 4 1 10 6 -1 2 1 0 4 3 -1 13 4 1 11 6 -1 3 2 0 4 3 -1 14 4
 1 12 6 -1 4 1 -2 16 2 -2 15 5 1 10 6 -1 5 1 0 4 3 -1 15 5 1 11 6 -1 6 2 0 4 3 -1
 16 5 1 12 6 -1 7 1 0 4 4 -1 15 5 1 13 6 -1 8 2 0 4 4 -1 16 5 1 14 6 -1 9
 16 9 48 1507 2 0 0 3 1 0
 1 -2 3 2 -2 2 3 1 1 1 -2 5 2 -2 4 4 1 1 1 0 3 3 -1 4 4 1 2 2 0 3 3 -1 5 4 1 3 1
 -2 7 2 -2 6 5 1 1 1 0 3 3 -1 6 5 1 2 2 0 3 3 -1 7 5 1 3 1 0 3 4 -1 6 5 1 4 2 0
 3 4 -1 7 5 1 5 1 -2 9 2 -2 8 6 1 1 1 0 3 3 -1 8 6 1 2 2 0 3 3 -1 9 6 1 3 1 0 3
 4 -1 8 6 1 4 2 0 3 4 -1 9 6 1 5 1 0 3 5 -1 8 6 1 6 2 0 3 5 -1 9 6 1 7
 9 6 18 1555 1 0 1 2 0 0
 1 1 2 2 1 1 1 1 3 3 1 1 2 1 3 3 1 2 1 1 4 4 1 1 2 1 4 4 1 2 1 1 5 5 1 1 2 1 5 5
 1 2 1 1 6 6 1 1 2 1 6 6 1 2
 1 14 30 1573 4 2 0 6 4 0
 0 0 14 0 2 14 0 -2 12 0 2 9 0 -2 5 0 0 14 0 2 13 0 -2 11 0 2 8 0 -2 4 0 -2 14 0
 -2 13 0 1 10 0 -1 7 0 1 3 0 2 12 0 2 11 0 -1 10 0 1 6 0 -1 2 0 -2 9 0 -2 8 0 1
 7 0 -1 6 0 1 1 0 2 5 0 2 4 0 -1 3 0 1 2 0 -1 1
 1 16 120 1603 3 1 0 6 4 0
 0 0 16 0 0 16 0 0 16 0 0 16 0 0 16 0 -2 16 0 2 14 0 -2 9 0 0 16 0 2 16 0 -2 12
 0 2 7 0 0 16 0 -2 14 0 2 12 0 -2 4 0 0 16 0 2 9 0 -2 7 0 2 4 0 0 16 0 0 16 0 0
 16 0 0 16 0 0 16 0 -2 15 0 2 13 0 -2 8 0 0 16 0 2 15 0 -2 11 0 2 6 0 0 16 0 -2
 13 0 2 11 0 -2 3 0 0 16 0 2 8 0 -2 6 0 2 3 0 0 16 0 2 16 0 -2 14 0 2 9 0 0 16 0
 2 15 0 -2 13 0 2 8 0 -2 16 0 -2 15 0 1 10 0 -1 5 0 2 14 0 2 13 0 -1 10 0 1 2 0
 -2 9 0 -2 8 0 1 5 0 -1 2 0 0 16 0 -2 16 0 2 12 0 -2 7 0 0 16 0 -2 15 0 2 11 0 -2
 6 0 2 16 0 2 15 0 -1 10 0 1 5 0 -2 12 0 -2 11 0 1 10 0 -1 1 0 2 7 0 2 6 0 -1 5
 0 1 1 0 0 16 0 2 14 0 -2 12 0 2 4 0 0 16 0 2 13 0 -2 11 0 2 3 0 -2 14 0 -2 13 0
 1 10 0 -1 2 0 2 12 0 2 11 0 -1 10 0 1 1 0 -2 4 0 -2 3 0 1 2 0 -1 1 0 0 16 0 -2
 9 0 2 7 0 -2 4 0 0 16 0 -2 8 0 2 6 0 -2 3 0 2 9 0 2 8 0 -1 5 0 1 2 0 -2 7 0 -2
 6 0 1 5 0 -1 1 0 2 4 0 2 3 0 -1 2 0 1 1
 1 9 360 1723 2 0 0 6 4 0
 0 0 9 0 0 9 0 0 9 0 0 9 0 0 9 0 0 9 0 0 9 0 0 9 0 0 9 0 0 9 0 0 9 0 0 9 0 0 9 0
 0 9 0 0 9 0 0 9 0 2 9 0 -2 7 0 0 9 0 -2 9 0 2 5 0 0 9 0 2 7 0 -2 5 0 0 9 0 0 9
 0 0 9 0 0 9 0 -2 9 0 2 7 0 0 9 0 2 9 0 -2 3 0 0 9 0 -2 7 0 2 3 0 0 9 0 0 9 0 0
 9 0 0 9 0 2 9 0 -2 5 0 0 9 0 -2 9 0 2 3 0 0 9 0 2 5 0 -2 3 0 0 9 0 0 9 0 0 9 0
 0 9 0 -2 7 0 2 5 0 0 9 0 2 7 0 -2 3 0 0 9 0 -2 5 0 2 3 0 0 9 0 0 9 0 0 9 0 0 9
 0 0 9 0 0 9 0 0 9 0 0 9 0 0 9 0 0 9 0 0 9 0 0 9 0 0 9 0 0 9 0 0 9 0 0 9 0 2 8 0
 -2 6 0 0 9 0 -2 8 0 2 4 0 0 9 0 2 6 0 -2 4 0 0 9 0 0 9 0 0 9 0 0 9 0 -2 8 0 2 6
 0 0 9 0 2 8 0 -2 2 0 0 9 0 -2 6 0 2 2 0 0 9 0 0 9 0 0 9 0 0 9 0 2 8 0 -2 4 0 0
 9 0 -2 8 0 2 2 0 0 9 0 2 4 0 -2 2 0 0 9 0 0 9 0 0 9 0 0 9 0 -2 6 0 2 4 0 0 9 0
 2 6 0 -2 2 0 0 9 0 -2 4 0 2 2 0 0 9 0 0 9 0 0 9 0 0 9 0 -2 9 0 2 7 0 0 9 0 2 9
 0 -2 5 0 0 9 0 -2 7 0 2 5 0 0 9 0 0 9 0 0 9 0 0 9 0 -2 8 0 2 6 0 0 9 0 2 8 0 -2
 4 0 0 9 0 -2 6 0 2 4 0 0 9 0 2 9 0 -2 7 0 0 9 0 2 8 0 -2 6 0 -2 9 0 -2 8 0 1 1
 0 2 7 0 2 6 0 -1 1 0 0 9 0 -2 9 0 2 5 0 0 9 0 -2 8 0 2 4 0 2 9 0 2 8 0 -1 1 0 -2
 5 0 -2 4 0 1 1 0 0 9 0 2 7 0 -2 5 0 0 9 0 2 6 0 -2 4 0 -2 7 0 -2 6 0 1 1 0 2 5
 0 2 4 0 -1 1 0 0 9 0 0 9 0 0 9 0 0 9 0 2 9 0 -2 7 0 0 9 0 -2 9 0 2 3 0 0 9 0 2
 7 0 -2 3 0 0 9 0 0 9 0 0 9 0 0 9 0 2 8 0 -2 6 0 0 9 0 -2 8 0 2 2 0 0 9 0 2 6 0
 -2 2 0 0 9 0 -2 9 0 2 7 0 0 9 0 -2 8 0 2 6 0 2 9 0 2 8 0 -1 1 0 -2 7 0 -2 6 0 1
 1 0 0 9 0 2 9 0 -2 3 0 0 9 0 2 8 0 -2 2 0 -2 9 0 -2 8 0 1 1 0 2 3 0 2 2 0 -1 1
 0 0 9 0 -2 7 0 2 3 0 0 9 0 -2 6 0 2 2 0 2 7 0 2 6 0 -1 1 0 -2 3 0 -2 2 0 1 1 0
 0 9 0 0 9 0 0 9 0 0 9 0 -2 9 0 2 5 0 0 9 0 2 9 0 -2 3 0 0 9 0 -2 5 0 2 3 0 0 9
 0 0 9 0 0 9 0 0 9 0 -2 8 0 2 4 0 0 9 0 2 8 0 -2 2 0 0 9 0 -2 4 0 2 2 0 0 9 0 2
 9 0 -2 5 0 0 9 0 2 8 0 -2 4 0 -2 9 0 -2 8 0 1 1 0 2 5 0 2 4 0 -1 1 0 0 9 0 -2 9
 0 2 3 0 0 9 0 -2 8 0 2 2 0 2 9 0 2 8 0 -1 1 0 -2 3 0 -2 2 0 1 1 0 0 9 0 2 5 0 -2
 3 0 0 9 0 2 4 0 -2 2 0 -2 5 0 -2 4 0 1 1 0 2 3 0 2 2 0 -1 1 0 0 9 0 0 9 0 0 9 0
 0 9 0 2 7 0 -2 5 0 0 9 0 -2 7 0 2 3 0 0 9 0 2 5 0 -2 3 0 0 9 0 0 9 0 0 9 0 0 9
 0 2 6 0 -2 4 0 0 9 0 -2 6 0 2 2 0 0 9 0 2 4 0 -2 2 0 0 9 0 -2 7 0 2 5 0 0 9 0 -2
 6 0 2 4 0 2 7 0 2 6 0 -1 1 0 -2 5 0 -2 4 0 1 1 0 0 9 0 2 7 0 -2 3 0 0 9 0 2 6 0
 -2 2 0 -2 7 0 -2 6 0 1 1 0 2 3 0 2 2 0 -1 1 0 0 9 0 -2 5 0 2 3 0 0 9 0 -2 4 0 2
 2 0 2 5 0 2 4 0 -1 1 0 -2 3 0 -2 2 0 1 1
 1 6 6 2083 5 3 0 6 4 0
 1 1 6 2 1 5 3 2 4 4 -2 3 5 2 2 6 -2 1
 0 0 0 0 0 0 0 0 0 0
 0 0 0 0 0 0 0 0 0 0
