 6 2 1 0 1 2 3 4 5 6
 1 27 30 1 4 2 2 6 2 0
 0 -2 27 0 1 26 0 1 21 0 2 16 0 -2 8 0 -2 27 0 1 24 0 1 19 0 2 14 0 -2 6 0 1 25
 0 1 23 0 -2 18 0 2 12 0 -2 4 0 1 22 0 1 20 0 -2 18 0 2 10 0 -2 2 0 2 17 0 2 15
 0 2 13 0 2 11 0 4 1 0 -2 9 0 -2 7 0 -2 5 0 -2 3 0 -4 1
 27 84 108 31 3 1 2 4 2 2
 1 1 10 2 1 7 3 1 4 4 1 1 1 -1 25 2 -1 18 3 -2 13 5 1 3 1 -1 26 2 -1 19 3 -2 15
 5 1 2 1 -1 36 2 -1 29 4 -2 13 5 1 5 1 -1 39 2 -1 33 4 -2 15 5 1 6 1 -2 40 3 -1
 30 4 -1 20 5 1 9 1 -2 42 3 -1 32 4 -1 21 5 1 8 2 -2 40 3 -1 34 4 -1 23 5 1 11 2
 -2 42 3 -1 38 4 -1 27 5 1 12 1 -1 55 2 -1 48 3 -2 43 6 1 3 1 -1 56 2 -1 49 3 -2
 45 6 1 2 1 -1 66 2 -1 59 4 -2 43 6 1 5 1 -1 69 2 -1 63 4 -2 45 6 1 6 1 -2 70 3
 -1 60 4 -1 50 6 1 9 1 -2 72 3 -1 62 4 -1 51 6 1 8 2 -2 70 3 -1 64 4 -1 53 6 1
 11 2 -2 72 3 -1 68 4 -1 57 6 1 12 1 -2 78 2 -2 74 5 1 44 6 -1 14 1 -2 79 3 -2
 75 5 1 46 6 -1 16 1 -2 81 3 -2 73 5 1 47 6 -1 17 2 -2 79 3 -2 77 5 1 52 6 -1 22
 2 -2 81 3 -2 76 5 1 54 6 -1 24 1 -2 83 4 -2 73 5 1 58 6 -1 28 1 -2 82 4 -2 75 5
 1 61 6 -1 31 2 -2 83 4 -2 76 5 1 65 6 -1 35 2 -2 82 4 -2 77 5 1 67 6 -1 37 3 -2
 84 4 -2 80 5 1 71 6 -1 41
 84 55 252 139 2 0 2 3 1 2
 1 -1 6 2 -1 4 3 0 6 1 1 5 2 1 2 3 -2 1 1 1 7 2 1 3 3 -2 1 1 -1 13 2 -1 10 4 0 6
 1 1 11 2 1 8 4 -2 1 1 1 12 2 1 9 4 -2 1 1 0 6 3 1 10 4 1 4 1 -2 14 3 1 8 4 1 3
 1 -2 14 3 1 9 4 1 2 2 0 6 3 1 13 4 1 6 2 -2 14 3 1 12 4 1 5 2 -2 14 3 1 11 4 1
 7 1 1 24 2 1 19 5 -1 1 1 -2 22 2 -2 16 5 1 1 1 1 21 2 1 18 5 -1 1 1 -2 25 3 -2
 17 5 1 2 1 -2 28 3 -2 15 5 1 3 1 0 6 3 -2 19 5 1 3 1 0 6 3 -2 18 5 1 2 1 -2 29
 3 0 6 5 1 2 1 -2 27 3 0 6 5 1 3 2 -2 25 3 -2 23 5 1 5 2 -2 29 3 0 6 5 1 5 2 -2
 28 3 -2 20 5 1 7 2 0 6 3 -2 24 5 1 7 2 0 6 3 -2 21 5 1 5 2 -2 27 3 0 6 5 1 7 1
 -2 32 4 -2 15 5 1 8 1 0 6 4 -2 19 5 1 8 1 -2 34 4 0 6 5 1 9 1 -2 31 4 -2 17 5 1
 9 1 -2 33 4 0 6 5 1 8 1 0 6 4 -2 18 5 1 9 2 -2 34 4 0 6 5 1 12 2 -2 32 4 -2 20
 5 1 11 2 0 6 4 -2 24 5 1 11 2 -2 31 4 -2 23 5 1 12 2 -2 33 4 0 6 5 1 11 2 0 6 4
 -2 21 5 1 12 3 1 34 4 1 29 5 -1 14 3 -2 30 4 -2 26 5 1 14 3 1 33 4 1 27 5 -1 14
 1 1 44 2 1 39 6 -1 1 1 -2 42 2 -2 35 6 1 1 1 1 40 2 1 38 6 -1 1 1 -2 46 3 -2 37
 6 1 2 1 -2 48 3 -2 36 6 1 3 1 0 6 3 -2 39 6 1 3 1 0 6 3 -2 38 6 1 2 1 -2 49 3 0
 6 6 1 2 1 -2 45 3 0 6 6 1 3 2 -2 46 3 -2 41 6 1 5 2 -2 49 3 0 6 6 1 5 2 -2 48 3
 -2 43 6 1 7 2 0 6 3 -2 44 6 1 7 2 0 6 3 -2 40 6 1 5 2 -2 45 3 0 6 6 1 7 1 -2 52
 4 -2 36 6 1 8 1 0 6 4 -2 39 6 1 8 1 -2 54 4 0 6 6 1 9 1 -2 53 4 -2 37 6 1 9 1 -2
 51 4 0 6 6 1 8 1 0 6 4 -2 38 6 1 9 2 -2 54 4 0 6 6 1 12 2 -2 52 4 -2 43 6 1 11
 2 0 6 4 -2 44 6 1 11 2 -2 53 4 -2 41 6 1 12 2 -2 51 4 0 6 6 1 11 2 0 6 4 -2 40
 6 1 12 3 1 54 4 1 49 6 -1 14 3 -2 50 4 -2 47 6 1 14 3 1 51 4 1 45 6 -1 14 1 -2
 55 5 -1 36 6 1 15 1 0 6 5 -1 35 6 1 16 1 2 55 5 -1 37 6 1 17 2 -2 55 5 -1 43 6
 1 20 2 2 55 5 -1 41 6 1 23 2 0 6 5 -1 42 6 1 22 3 -2 55 5 -1 46 6 1 25 3 0 6 5
 -1 47 6 1 26 3 2 55 5 -1 48 6 1 28 4 -2 55 5 -1 53 6 1 31 4 2 55 5 -1 52 6 1 32
 4 0 6 5 -1 50 6 1 30
 55 6 110 391 1 0 1 2 0 2
 1 1 2 2 1 1 1 1 3 3 -2 1 1 -2 3 3 1 1 1 1 3 3 -1 1 2 1 3 3 -2 2 2 1 3 3 -1 2 2
 -2 3 3 1 2 1 -2 4 4 1 1 1 1 4 4 -2 1 1 1 4 4 -1 1 2 -2 4 4 1 2 2 1 4 4 -2 2 2 1
 4 4 -1 2 3 1 4 4 1 3 1 -2 5 5 1 1 1 1 5 5 1 1 1 1 5 5 -2 1 1 1 5 5 0 2 1 0 2 5
 1 1 2 -2 5 5 1 2 2 1 5 5 0 2 2 1 5 5 1 2 2 1 5 5 -2 2 2 0 2 5 1 2 3 -2 5 5 1 3
 3 1 5 5 1 3 3 1 5 5 0 2 3 1 5 5 -2 3 3 0 2 5 1 3 4 1 5 5 1 4 4 -2 5 5 1 4 4 1 5
 5 -2 4 4 1 5 5 0 2 4 0 2 5 1 4 1 1 6 6 1 1 1 -2 6 6 1 1 1 1 6 6 -2 1 1 1 6 6 0
 2 1 0 2 6 1 1 2 1 6 6 0 2 2 1 6 6 -2 2 2 1 6 6 1 2 2 -2 6 6 1 2 2 0 2 6 1 2 3 1
 6 6 0 2 3 -2 6 6 1 3 3 1 6 6 1 3 3 1 6 6 -2 3 3 0 2 6 1 3 4 1 6 6 1 4 4 1 6 6 0
 2 4 1 6 6 -2 4 4 -2 6 6 1 4 4 0 2 6 1 4 5 1 6 6 -1 5
 6 1 6 501 0 0 0 1 0 1
 1 1 1 2 1 1 3 1 1 4 1 1 5 1 1 6 1 1
 1 84 120 507 3 1 2 6 2 0
 0 -2 82 0 -2 79 0 -4 70 0 4 40 0 -2 83 0 4 78 0 -2 66 0 2 36 0 -2 81 0 4 78 0 -2
 55 0 2 25 0 -4 72 0 -2 69 0 -2 56 0 4 10 0 4 42 0 2 39 0 2 26 0 -4 10 0 -2 82 0
 -2 79 0 -4 70 0 4 40 0 -2 83 0 4 74 0 -2 59 0 2 29 0 -2 81 0 4 74 0 -2 48 0 2
 18 0 -4 72 0 -2 63 0 -2 49 0 4 7 0 4 42 0 2 33 0 2 19 0 -4 7 0 4 84 0 -2 77 0 -2
 64 0 2 34 0 4 84 0 -2 75 0 -2 60 0 2 30 0 -2 76 0 -2 73 0 -4 43 0 4 13 0 -2 68
 0 -2 62 0 -4 45 0 4 4 0 2 38 0 2 32 0 4 15 0 -4 4 0 4 80 0 -2 77 0 -2 53 0 2 23
 0 4 80 0 -2 75 0 -2 50 0 2 20 0 -2 76 0 -2 73 0 -4 43 0 4 13 0 -2 57 0 -2 51 0
 -4 45 0 4 1 0 2 27 0 2 21 0 4 15 0 -4 1 0 -2 71 0 1 67 0 1 52 0 -2 11 0 -2 71 0
 1 61 0 1 46 0 -2 9 0 1 65 0 1 58 0 -2 44 0 -2 5 0 1 54 0 1 47 0 -2 44 0 -2 3 0
 -2 12 0 -2 8 0 -2 6 0 -2 2 0 2 41 0 -1 37 0 -1 22 0 2 11 0 2 41 0 -1 31 0 -1 16
 0 2 9 0 -1 35 0 -1 28 0 2 14 0 2 5 0 -1 24 0 -1 17 0 2 14 0 2 3 0 2 12 0 2 8 0
 2 6 0 2 2
 1 55 360 627 2 0 2 6 2 0
 0 0 55 0 0 55 0 0 55 0 0 55 0 0 55 0 0 55 0 0 55 0 0 55 0 0 55 0 0 55 0 0 55 0
 0 55 0 4 55 0 -4 54 0 4 34 0 -4 55 0 4 44 0 -4 24 0 -4 51 0 4 40 0 4 13 0 4 33
 0 -4 21 0 -4 13 0 4 55 0 -4 49 0 4 29 0 -4 55 0 4 44 0 -4 24 0 -4 45 0 4 40 0 4
 6 0 4 27 0 -4 21 0 -4 6 0 2 53 0 2 46 0 -4 14 0 2 52 0 -4 42 0 2 11 0 2 48 0 -4
 42 0 2 7 0 -4 14 0 2 12 0 2 5 0 -2 31 0 -2 25 0 4 14 0 -2 32 0 4 22 0 -2 11 0 -2
 28 0 4 22 0 -2 7 0 4 14 0 -2 12 0 -2 5 0 0 55 0 0 55 0 0 55 0 0 55 0 0 55 0 0
 55 0 0 55 0 0 55 0 0 55 0 0 55 0 0 55 0 0 55 0 4 55 0 -4 54 0 4 34 0 -4 55 0 4
 39 0 -4 19 0 -4 51 0 4 38 0 4 10 0 4 33 0 -4 18 0 -4 10 0 4 55 0 -4 49 0 4 29 0
 -4 55 0 4 39 0 -4 19 0 -4 45 0 4 38 0 4 4 0 4 27 0 -4 18 0 -4 4 0 2 53 0 2 46 0
 -4 14 0 2 52 0 -4 35 0 2 8 0 2 48 0 -4 35 0 2 3 0 -4 14 0 2 9 0 2 2 0 -2 31 0 -2
 25 0 4 14 0 -2 32 0 4 16 0 -2 8 0 -2 28 0 4 16 0 -2 3 0 4 14 0 -2 9 0 -2 2 0 -4
 55 0 4 54 0 -4 34 0 4 55 0 -4 44 0 4 24 0 4 51 0 -4 40 0 -4 13 0 -4 33 0 4 21 0
 4 13 0 -4 55 0 4 54 0 -4 34 0 4 55 0 -4 39 0 4 19 0 4 51 0 -4 38 0 -4 10 0 -4
 33 0 4 18 0 4 10 0 0 55 0 0 55 0 0 55 0 0 55 0 0 55 0 0 55 0 0 55 0 0 55 0 0 55
 0 0 55 0 0 55 0 0 55 0 -4 50 0 2 41 0 2 12 0 -4 50 0 2 37 0 2 9 0 2 43 0 2 36 0
 -4 1 0 2 11 0 2 8 0 -4 1 0 4 30 0 -2 23 0 -2 12 0 4 30 0 -2 17 0 -2 9 0 -2 20 0
 -2 15 0 4 1 0 -2 11 0 -2 8 0 4 1 0 -4 55 0 4 49 0 -4 29 0 4 55 0 -4 44 0 4 24 0
 4 45 0 -4 40 0 -4 6 0 -4 27 0 4 21 0 4 6 0 -4 55 0 4 49 0 -4 29 0 4 55 0 -4 39
 0 4 19 0 4 45 0 -4 38 0 -4 4 0 -4 27 0 4 18 0 4 4 0 0 55 0 0 55 0 0 55 0 0 55 0
 0 55 0 0 55 0 0 55 0 0 55 0 0 55 0 0 55 0 0 55 0 0 55 0 -4 47 0 2 41 0 2 5 0 -4
 47 0 2 37 0 2 2 0 2 43 0 2 36 0 -4 1 0 2 7 0 2 3 0 -4 1 0 4 26 0 -2 23 0 -2 5 0
 4 26 0 -2 17 0 -2 2 0 -2 20 0 -2 15 0 4 1 0 -2 7 0 -2 3 0 4 1 0 -2 53 0 -2 46 0
 4 14 0 -2 52 0 4 42 0 -2 11 0 -2 48 0 4 42 0 -2 7 0 4 14 0 -2 12 0 -2 5 0 -2 53
 0 -2 46 0 4 14 0 -2 52 0 4 35 0 -2 8 0 -2 48 0 4 35 0 -2 3 0 4 14 0 -2 9 0 -2 2
 0 4 50 0 -2 41 0 -2 12 0 4 50 0 -2 37 0 -2 9 0 -2 43 0 -2 36 0 4 1 0 -2 11 0 -2
 8 0 4 1 0 4 47 0 -2 41 0 -2 5 0 4 47 0 -2 37 0 -2 2 0 -2 43 0 -2 36 0 4 1 0 -2
 7 0 -2 3 0 4 1 0 -2 14 0 1 12 0 1 5 0 -2 14 0 1 9 0 1 2 0 1 11 0 1 8 0 -2 1 0 1
 7 0 1 3 0 -2 1 0 2 31 0 2 25 0 -4 14 0 2 32 0 -4 22 0 2 11 0 2 28 0 -4 22 0 2 7
 0 -4 14 0 2 12 0 2 5 0 2 31 0 2 25 0 -4 14 0 2 32 0 -4 16 0 2 8 0 2 28 0 -4 16
 0 2 3 0 -4 14 0 2 9 0 2 2 0 -4 30 0 2 23 0 2 12 0 -4 30 0 2 17 0 2 9 0 2 20 0 2
 15 0 -4 1 0 2 11 0 2 8 0 -4 1 0 -4 26 0 2 23 0 2 5 0 -4 26 0 2 17 0 2 2 0 2 20
 0 2 15 0 -4 1 0 2 7 0 2 3 0 -4 1 0 2 14 0 -1 12 0 -1 5 0 2 14 0 -1 9 0 -1 2 0 -1
 11 0 -1 8 0 2 1 0 -1 7 0 -1 3 0 2 1
 1 36 120 987 3 2 1 6 2 0
 0 -2 36 0 -2 35 0 -4 32 0 4 18 0 -2 36 0 1 34 0 -2 31 0 2 17 0 -2 35 0 1 34 0 -2
 25 0 2 11 0 -4 32 0 -2 31 0 -2 25 0 0 36 0 4 18 0 2 17 0 2 11 0 0 36 0 -2 36 0
 -2 35 0 -4 32 0 4 18 0 -2 36 0 1 33 0 -2 27 0 2 13 0 -2 35 0 1 33 0 -2 21 0 2 7
 0 -4 32 0 -2 27 0 -2 21 0 0 36 0 4 18 0 2 13 0 2 7 0 0 36 0 1 36 0 -2 34 0 -2
 30 0 2 16 0 1 36 0 -2 33 0 -2 28 0 2 14 0 -2 34 0 -2 33 0 -4 19 0 4 5 0 -2 30 0
 -2 28 0 -4 19 0 0 36 0 2 16 0 2 14 0 4 5 0 0 36 0 1 35 0 -2 34 0 -2 24 0 2 10 0
 1 35 0 -2 33 0 -2 22 0 2 8 0 -2 34 0 -2 33 0 -4 19 0 4 5 0 -2 24 0 -2 22 0 -4
 19 0 0 36 0 2 10 0 2 8 0 4 5 0 0 36 0 2 32 0 -4 29 0 -4 23 0 -4 4 0 2 32 0 -4
 26 0 -4 20 0 -4 3 0 -4 29 0 -4 26 0 2 19 0 -4 2 0 -4 23 0 -4 20 0 2 19 0 -4 1 0
 -4 4 0 -4 3 0 -4 2 0 -4 1 0 -2 18 0 4 15 0 4 9 0 4 4 0 -2 18 0 4 12 0 4 6 0 4 3
 0 4 15 0 4 12 0 -2 5 0 4 2 0 4 9 0 4 6 0 -2 5 0 4 1 0 4 4 0 4 3 0 4 2 0 4 1
 36 47 108 1107 2 1 1 3 2 1
 1 -1 9 2 -1 2 3 1 1 1 -1 21 2 -1 13 4 1 1 1 1 22 3 -1 16 4 -1 6 2 1 22 3 -1 18
 4 -1 8 1 -1 27 2 -1 24 5 1 1 1 -1 30 3 -1 24 5 1 5 1 -2 31 3 1 23 5 -1 3 1 1 29
 3 -2 25 5 -1 4 2 -1 30 3 -1 27 5 1 11 2 1 29 3 -2 28 5 -1 7 2 -2 31 3 1 26 5 -1
 10 1 -1 32 4 -1 24 5 1 14 1 -2 34 4 1 23 5 -1 12 1 1 33 4 -2 25 5 -1 15 2 -1 32
 4 -1 27 5 1 20 2 1 33 4 -2 28 5 -1 19 2 -2 34 4 1 26 5 -1 17 3 -1 32 4 -1 30 5
 1 22 1 -1 39 2 -1 36 6 1 1 1 -1 42 3 -1 36 6 1 5 1 -2 43 3 1 35 6 -1 3 1 1 41 3
 -2 37 6 -1 4 2 -1 42 3 -1 39 6 1 11 2 1 41 3 -2 40 6 -1 7 2 -2 43 3 1 38 6 -1
 10 1 -1 44 4 -1 36 6 1 14 1 -2 46 4 1 35 6 -1 12 1 1 45 4 -2 37 6 -1 15 2 -1 44
 4 -1 39 6 1 20 2 1 45 4 -2 40 6 -1 19 2 -2 46 4 1 38 6 -1 17 3 -1 44 4 -1 42 6
 1 22 1 -2 47 5 1 35 6 -1 23 2 -2 47 5 1 38 6 -1 26 3 -2 47 5 1 41 6 -1 29 4 -2
 47 5 1 45 6 -1 33
 47 6 94 1215 1 0 1 2 1 1
 1 1 2 2 1 1 1 0 2 3 1 1 1 -2 3 3 1 1 1 1 3 3 -2 1 1 1 3 3 1 1 1 1 3 3 0 2 2 1 3
 3 -2 2 2 1 3 3 0 2 2 0 2 3 1 2 2 -2 3 3 1 2 2 1 3 3 1 2 1 -2 4 4 1 1 1 0 2 4 1
 1 1 1 4 4 1 1 1 1 4 4 -2 1 1 1 4 4 0 2 2 -2 4 4 1 2 2 1 4 4 0 2 2 1 4 4 -2 2 2
 1 4 4 1 2 2 0 2 4 1 2 3 1 4 4 1 3 1 -2 5 5 1 1 1 0 2 5 1 1 1 -1 5 5 1 1 2 -2 5
 5 1 2 2 0 2 5 1 2 2 -1 5 5 1 2 3 -2 5 5 1 3 3 0 2 5 1 3 3 -1 5 5 1 3 4 0 2 5 1
 4 4 -2 5 5 1 4 4 -1 5 5 1 4 1 -2 6 6 1 1 1 0 2 6 1 1 1 -1 6 6 1 1 2 -2 6 6 1 2
 2 0 2 6 1 2 2 -1 6 6 1 2 3 -2 6 6 1 3 3 0 2 6 1 3 3 -1 6 6 1 3 4 0 2 6 1 4 4 -2
 6 6 1 4 4 -1 6 6 1 4 5 -1 6 6 1 5
 1 47 360 1309 2 1 1 6 2 0
 0 -2 47 0 4 46 0 -4 34 0 -2 47 0 4 43 0 -4 31 0 4 46 0 4 43 0 0 47 0 -4 34 0 -4
 31 0 0 47 0 4 47 0 -2 45 0 2 33 0 4 47 0 4 39 0 -4 27 0 -2 45 0 4 39 0 0 47 0 2
 33 0 -4 27 0 0 47 0 4 47 0 -2 41 0 2 29 0 4 47 0 4 39 0 -4 27 0 -2 41 0 4 39 0
 0 47 0 2 29 0 -4 27 0 0 47 0 4 44 0 4 42 0 -4 22 0 4 44 0 -2 39 0 4 21 0 4 42 0
 -2 39 0 4 9 0 -4 22 0 4 21 0 4 9 0 -4 32 0 -4 30 0 4 22 0 -4 32 0 2 27 0 -4 21
 0 -4 30 0 2 27 0 -4 9 0 4 22 0 -4 21 0 -4 9 0 -2 47 0 4 46 0 -4 34 0 -2 47 0 4
 43 0 -4 31 0 4 46 0 4 43 0 0 47 0 -4 34 0 -4 31 0 0 47 0 4 47 0 -2 45 0 2 33 0
 4 47 0 4 36 0 -4 24 0 -2 45 0 4 36 0 0 47 0 2 33 0 -4 24 0 0 47 0 4 47 0 -2 41
 0 2 29 0 4 47 0 4 36 0 -4 24 0 -2 41 0 4 36 0 0 47 0 2 29 0 -4 24 0 0 47 0 4 44
 0 4 42 0 -4 22 0 4 44 0 -2 36 0 4 13 0 4 42 0 -2 36 0 4 2 0 -4 22 0 4 13 0 4 2
 0 -4 32 0 -4 30 0 4 22 0 -4 32 0 2 24 0 -4 13 0 -4 30 0 2 24 0 -4 2 0 4 22 0 -4
 13 0 -4 2 0 4 47 0 4 44 0 -4 32 0 4 47 0 -2 38 0 2 26 0 4 44 0 -2 38 0 0 47 0 -4
 32 0 2 26 0 0 47 0 4 47 0 4 44 0 -4 32 0 4 47 0 -2 35 0 2 23 0 4 44 0 -2 35 0 0
 47 0 -4 32 0 2 23 0 0 47 0 -2 47 0 4 40 0 -4 28 0 -2 47 0 4 37 0 -4 25 0 4 40 0
 4 37 0 0 47 0 -4 28 0 -4 25 0 0 47 0 -2 44 0 4 39 0 4 18 0 -2 44 0 4 36 0 4 16
 0 4 39 0 4 36 0 -4 1 0 4 18 0 4 16 0 -4 1 0 2 32 0 -4 27 0 -4 18 0 2 32 0 -4 24
 0 -4 16 0 -4 27 0 -4 24 0 4 1 0 -4 18 0 -4 16 0 4 1 0 4 47 0 4 42 0 -4 30 0 4
 47 0 -2 38 0 2 26 0 4 42 0 -2 38 0 0 47 0 -4 30 0 2 26 0 0 47 0 4 47 0 4 42 0 -4
 30 0 4 47 0 -2 35 0 2 23 0 4 42 0 -2 35 0 0 47 0 -4 30 0 2 23 0 0 47 0 -2 47 0
 4 40 0 -4 28 0 -2 47 0 4 37 0 -4 25 0 4 40 0 4 37 0 0 47 0 -4 28 0 -4 25 0 0 47
 0 -2 42 0 4 39 0 4 8 0 -2 42 0 4 36 0 4 6 0 4 39 0 4 36 0 -4 1 0 4 8 0 4 6 0 -4
 1 0 2 30 0 -4 27 0 -4 8 0 2 30 0 -4 24 0 -4 6 0 -4 27 0 -4 24 0 4 1 0 -4 8 0 -4
 6 0 4 1 0 -2 45 0 -2 41 0 4 22 0 -2 45 0 1 38 0 -2 17 0 -2 41 0 1 38 0 -2 10 0
 4 22 0 -2 17 0 -2 10 0 -2 45 0 -2 41 0 4 22 0 -2 45 0 1 35 0 -2 12 0 -2 41 0 1
 35 0 -2 3 0 4 22 0 -2 12 0 -2 3 0 1 45 0 -2 38 0 -2 19 0 1 45 0 -2 35 0 -2 15 0
 -2 38 0 -2 35 0 4 1 0 -2 19 0 -2 15 0 4 1 0 1 41 0 -2 38 0 -2 7 0 1 41 0 -2 35
 0 -2 4 0 -2 38 0 -2 35 0 4 1 0 -2 7 0 -2 4 0 4 1 0 -2 22 0 4 20 0 4 11 0 -2 22
 0 4 14 0 4 5 0 4 20 0 4 14 0 -2 1 0 4 11 0 4 5 0 -2 1 0 2 33 0 2 29 0 -4 22 0 2
 33 0 -1 26 0 2 17 0 2 29 0 -1 26 0 2 10 0 -4 22 0 2 17 0 2 10 0 2 33 0 2 29 0 -4
 22 0 2 33 0 -1 23 0 2 12 0 2 29 0 -1 23 0 2 3 0 -4 22 0 2 12 0 2 3 0 -1 33 0 2
 26 0 2 19 0 -1 33 0 2 23 0 2 15 0 2 26 0 2 23 0 -4 1 0 2 19 0 2 15 0 -4 1 0 -1
 29 0 2 26 0 2 7 0 -1 29 0 2 23 0 2 4 0 2 26 0 2 23 0 -4 1 0 2 7 0 2 4 0 -4 1 0
 2 22 0 -4 20 0 -4 11 0 2 22 0 -4 14 0 -4 5 0 -4 20 0 -4 14 0 2 1 0 -4 11 0 -4 5
 0 2 1
 1 13 360 1669 2 2 0 6 2 0
 0 1 13 0 -2 12 0 2 8 0 1 13 0 -2 11 0 2 7 0 -2 12 0 -2 11 0 0 13 0 2 8 0 2 7 0
 0 13 0 -2 13 0 4 12 0 -4 8 0 -2 13 0 4 10 0 -4 6 0 4 12 0 4 10 0 0 13 0 -4 8 0
 -4 6 0 0 13 0 -2 13 0 4 11 0 -4 7 0 -2 13 0 4 10 0 -4 6 0 4 11 0 4 10 0 0 13 0
 -4 7 0 -4 6 0 0 13 0 4 12 0 4 11 0 0 13 0 4 12 0 -2 10 0 4 4 0 4 11 0 -2 10 0 4
 2 0 0 13 0 4 4 0 4 2 0 -4 8 0 -4 7 0 0 13 0 -4 8 0 2 6 0 -4 4 0 -4 7 0 2 6 0 -4
 2 0 0 13 0 -4 4 0 -4 2 0 1 13 0 -2 12 0 2 8 0 1 13 0 -2 11 0 2 7 0 -2 12 0 -2
 11 0 0 13 0 2 8 0 2 7 0 0 13 0 -2 13 0 4 12 0 -4 8 0 -2 13 0 4 9 0 -4 5 0 4 12
 0 4 9 0 0 13 0 -4 8 0 -4 5 0 0 13 0 -2 13 0 4 11 0 -4 7 0 -2 13 0 4 9 0 -4 5 0
 4 11 0 4 9 0 0 13 0 -4 7 0 -4 5 0 0 13 0 4 12 0 4 11 0 0 13 0 4 12 0 -2 9 0 4 3
 0 4 11 0 -2 9 0 4 1 0 0 13 0 4 3 0 4 1 0 -4 8 0 -4 7 0 0 13 0 -4 8 0 2 5 0 -4 3
 0 -4 7 0 2 5 0 -4 1 0 0 13 0 -4 3 0 -4 1 0 -2 13 0 4 12 0 -4 8 0 -2 13 0 4 10 0
 -4 6 0 4 12 0 4 10 0 0 13 0 -4 8 0 -4 6 0 0 13 0 -2 13 0 4 12 0 -4 8 0 -2 13 0
 4 9 0 -4 5 0 4 12 0 4 9 0 0 13 0 -4 8 0 -4 5 0 0 13 0 1 13 0 -2 10 0 2 6 0 1 13
 0 -2 9 0 2 5 0 -2 10 0 -2 9 0 0 13 0 2 6 0 2 5 0 0 13 0 -2 12 0 4 10 0 -4 4 0 -2
 12 0 4 9 0 -4 3 0 4 10 0 4 9 0 0 13 0 -4 4 0 -4 3 0 0 13 0 2 8 0 -4 6 0 4 4 0 2
 8 0 -4 5 0 4 3 0 -4 6 0 -4 5 0 0 13 0 4 4 0 4 3 0 0 13 0 -2 13 0 4 11 0 -4 7 0
 -2 13 0 4 10 0 -4 6 0 4 11 0 4 10 0 0 13 0 -4 7 0 -4 6 0 0 13 0 -2 13 0 4 11 0
 -4 7 0 -2 13 0 4 9 0 -4 5 0 4 11 0 4 9 0 0 13 0 -4 7 0 -4 5 0 0 13 0 1 13 0 -2
 10 0 2 6 0 1 13 0 -2 9 0 2 5 0 -2 10 0 -2 9 0 0 13 0 2 6 0 2 5 0 0 13 0 -2 11 0
 4 10 0 -4 2 0 -2 11 0 4 9 0 -4 1 0 4 10 0 4 9 0 0 13 0 -4 2 0 -4 1 0 0 13 0 2 7
 0 -4 6 0 4 2 0 2 7 0 -4 5 0 4 1 0 -4 6 0 -4 5 0 0 13 0 4 2 0 4 1 0 0 13 0 4 12
 0 4 11 0 0 13 0 4 12 0 -2 10 0 4 4 0 4 11 0 -2 10 0 4 2 0 0 13 0 4 4 0 4 2 0 4
 12 0 4 11 0 0 13 0 4 12 0 -2 9 0 4 3 0 4 11 0 -2 9 0 4 1 0 0 13 0 4 3 0 4 1 0 -2
 12 0 4 10 0 -4 4 0 -2 12 0 4 9 0 -4 3 0 4 10 0 4 9 0 0 13 0 -4 4 0 -4 3 0 0 13
 0 -2 11 0 4 10 0 -4 2 0 -2 11 0 4 9 0 -4 1 0 4 10 0 4 9 0 0 13 0 -4 2 0 -4 1 0
 0 13 0 0 13 0 0 13 0 0 13 0 0 13 0 0 13 0 0 13 0 0 13 0 0 13 0 0 13 0 0 13 0 0
 13 0 0 13 0 -4 8 0 -4 7 0 0 13 0 -4 8 0 2 6 0 -4 4 0 -4 7 0 2 6 0 -4 2 0 0 13 0
 -4 4 0 -4 2 0 -4 8 0 -4 7 0 0 13 0 -4 8 0 2 5 0 -4 3 0 -4 7 0 2 5 0 -4 1 0 0 13
 0 -4 3 0 -4 1 0 2 8 0 -4 6 0 4 4 0 2 8 0 -4 5 0 4 3 0 -4 6 0 -4 5 0 0 13 0 4 4
 0 4 3 0 0 13 0 2 7 0 -4 6 0 4 2 0 2 7 0 -4 5 0 4 1 0 -4 6 0 -4 5 0 0 13 0 4 2 0
 4 1 0 0 13 0 0 13 0 0 13 0 0 13 0 0 13 0 0 13 0 0 13 0 0 13 0 0 13 0 0 13 0 0
 13 0 0 13 0 0 13
 13 6 26 2029 1 1 0 2 2 0
 1 1 3 3 -1 1 2 1 3 3 -1 2 1 1 4 4 -1 1 2 1 4 4 -1 2 1 1 5 5 -1 1 2 1 5 5 -1 2 3
 1 5 5 -1 3 4 1 5 5 -1 4 1 1 6 6 -1 1 2 1 6 6 -1 2 3 1 6 6 -1 3 4 1 6 6 -1 4 5 1
 6 6 -1 5
 6 1 6 2055 0 0 0 1 1 0
 1 1 1 2 1 1 3 1 1 4 1 1 5 1 1 6 1 1
 1 6 6 2061 5 2 1 6 2 0
 1 1 6 2 1 5 3 1 4 4 1 3 5 2 2 6 -2 1
 6 27 30 2067 4 1 1 5 2 1
 1 -1 9 2 -1 7 3 -1 5 4 -1 3 5 1 1 1 -1 17 2 -1 15 3 -1 13 4 -1 11 6 1 1 1 -2 22
 2 -2 19 3 -2 18 5 1 10 6 -1 2 1 -2 26 2 -2 23 4 -2 18 5 1 12 6 -1 4 1 -2 27 3 -2
 24 4 -2 20 5 1 14 6 -1 6 2 -2 27 3 -2 25 4 -2 21 5 1 16 6 -1 8
 27 36 108 2097 3 0 1 4 1 1
 1 1 4 2 1 3 3 1 2 4 1 1 1 -2 10 2 -2 6 3 -2 5 5 1 1 1 -2 11 2 -2 8 3 0 4 5 1 1
 1 -2 16 2 -2 13 4 -2 5 5 1 2 1 -2 17 2 -2 14 4 0 4 5 1 2 1 -2 18 3 -2 12 4 -2 7
 5 1 3 1 0 4 3 2 14 4 2 8 5 1 3 2 -2 18 3 -2 15 4 -2 9 5 1 4 2 0 4 3 2 17 4 2 11
 5 1 4 1 -2 25 2 -2 20 3 -2 19 6 1 1 1 -2 24 2 -2 22 3 0 4 6 1 1 1 -2 30 2 -2 27
 4 -2 19 6 1 2 1 -2 31 2 -2 28 4 0 4 6 1 2 1 -2 32 3 -2 26 4 -2 21 6 1 3 1 0 4 3
 2 28 4 2 22 6 1 3 2 -2 32 3 -2 29 4 -2 23 6 1 4 2 0 4 3 2 31 4 2 24 6 1 4 1 2
 34 2 2 33 5 -1 19 6 1 5 1 0 4 3 -2 33 5 -1 20 6 1 6 1 -2 35 3 0 4 5 -1 21 6 1 7
 2 -2 35 3 0 4 5 -1 23 6 1 9 2 0 4 3 -2 34 5 -1 25 6 1 10 1 0 4 4 -2 33 5 -1 27
 6 1 13 1 -2 36 4 0 4 5 -1 26 6 1 12 2 -2 36 4 0 4 5 -1 29 6 1 15 2 0 4 4 -2 34
 5 -1 30 6 1 16 3 2 36 4 2 35 5 -1 32 6 1 18
 36 14 108 2205 2 0 0 3 0 1
 1 -2 3 2 -2 2 3 1 1 1 -2 5 2 -2 4 4 1 1 1 1 6 3 -2 4 4 -2 2 2 1 6 3 -2 5 4 -2 3
 1 -2 8 2 -2 7 5 1 1 1 -2 9 3 1 7 5 -2 2 1 1 9 3 -2 7 5 -2 2 1 -1 9 3 1 7 5 0 3
 2 1 9 3 -2 8 5 -2 3 2 -2 9 3 1 8 5 -2 3 2 -1 9 3 1 8 5 0 3 1 1 10 4 -2 7 5 -2 4
 1 -2 10 4 1 7 5 -2 4 1 -1 10 4 1 7 5 0 3 2 1 10 4 -2 8 5 -2 5 2 -2 10 4 1 8 5 -2
 5 2 -1 10 4 1 8 5 0 3 3 -2 10 4 -2 9 5 1 6 1 -2 12 2 -2 11 6 1 1 1 -2 13 3 1 11
 6 -2 2 1 1 13 3 -2 11 6 -2 2 1 -1 13 3 1 11 6 0 3 2 1 13 3 -2 12 6 -2 3 2 -1 13
 3 1 12 6 0 3 2 -2 13 3 1 12 6 -2 3 1 1 14 4 -2 11 6 -2 4 1 -2 14 4 1 11 6 -2 4
 1 -1 14 4 1 11 6 0 3 2 1 14 4 -2 12 6 -2 5 2 -2 14 4 1 12 6 -2 5 2 -1 14 4 1 12
 6 0 3 3 -2 14 4 -2 13 6 1 6 1 0 3 5 -1 11 6 1 7 2 0 3 5 -1 12 6 1 8 3 0 3 5 -1
 13 6 1 9 4 0 3 5 -1 14 6 1 10
 14 6 28 2313 1 0 1 2 0 0
 1 1 2 2 1 1 1 1 3 3 1 1 2 1 3 3 1 2 1 1 4 4 1 1 2 1 4 4 1 2 3 1 4 4 1 3 1 1 5 5
 1 1 2 1 5 5 1 2 3 1 5 5 1 3 4 1 5 5 1 4 1 1 6 6 1 1 2 1 6 6 1 2 3 1 6 6 1 3 4 1
 6 6 1 4
 1 27 30 2341 4 1 1 6 2 0
 0 -2 27 0 -2 26 0 -2 22 0 -2 17 0 2 9 0 -2 27 0 -2 23 0 -2 19 0 -2 15 0 2 7 0 -2
 25 0 -2 24 0 -2 18 0 -2 13 0 2 5 0 -2 21 0 -2 20 0 -2 18 0 -2 11 0 2 3 0 1 16 0
 1 14 0 1 12 0 1 10 0 -2 1 0 -1 8 0 -1 6 0 -1 4 0 -1 2 0 2 1
 1 36 120 2371 3 0 1 6 2 0
 0 0 36 0 0 36 0 0 36 0 0 36 0 -4 36 0 4 34 0 -4 31 0 4 17 0 -4 35 0 4 34 0 -4
 24 0 4 11 0 2 32 0 2 30 0 2 25 0 2 4 0 -2 18 0 -2 16 0 -2 10 0 -2 4 0 0 36 0 0
 36 0 0 36 0 0 36 0 -4 36 0 4 33 0 -4 28 0 4 14 0 -4 35 0 4 33 0 -4 22 0 4 8 0 2
 32 0 2 27 0 2 20 0 2 3 0 -2 18 0 -2 13 0 -2 6 0 -2 3 0 4 36 0 -4 34 0 4 31 0 -4
 17 0 4 36 0 -4 33 0 4 28 0 -4 14 0 0 36 0 0 36 0 0 36 0 0 36 0 2 29 0 2 26 0 2
 19 0 2 2 0 -2 15 0 -2 12 0 -2 5 0 -2 2 0 4 35 0 -4 34 0 4 24 0 -4 11 0 4 35 0 -4
 33 0 4 22 0 -4 8 0 0 36 0 0 36 0 0 36 0 0 36 0 2 23 0 2 21 0 2 19 0 2 1 0 -2 9
 0 -2 7 0 -2 5 0 -2 1 0 -2 32 0 -2 30 0 -2 25 0 -2 4 0 -2 32 0 -2 27 0 -2 20 0 -2
 3 0 -2 29 0 -2 26 0 -2 19 0 -2 2 0 -2 23 0 -2 21 0 -2 19 0 -2 1 0 1 4 0 1 3 0 1
 2 0 1 1 0 2 18 0 2 16 0 2 10 0 2 4 0 2 18 0 2 13 0 2 6 0 2 3 0 2 15 0 2 12 0 2
 5 0 2 2 0 2 9 0 2 7 0 2 5 0 2 1 0 -1 4 0 -1 3 0 -1 2 0 -1 1
 1 14 30 2491 4 2 0 6 2 0
 0 1 14 0 -2 13 0 -2 11 0 -2 8 0 2 4 0 1 14 0 -2 12 0 -2 10 0 -2 7 0 2 3 0 -2 13
 0 -2 12 0 1 9 0 -2 6 0 2 2 0 -2 11 0 -2 10 0 1 9 0 -2 5 0 2 1 0 -2 8 0 -2 7 0 -2
 6 0 -2 5 0 0 14 0 2 4 0 2 3 0 2 2 0 2 1 0 0 14
 14 36 56 2521 3 1 0 4 2 0
 1 -2 11 2 -2 7 3 1 5 5 -1 1 1 -2 17 2 -2 13 4 1 5 5 -1 2 1 1 18 3 -2 14 4 -2 8
 5 -1 3 2 1 18 3 -2 16 4 -2 10 5 -1 4 1 -2 25 2 -2 21 3 1 19 6 -1 1 1 -2 31 2 -2
 27 4 1 19 6 -1 2 1 1 32 3 -2 28 4 -2 22 6 -1 3 2 1 32 3 -2 30 4 -2 24 6 -1 4 1
 -2 34 2 -2 33 5 1 19 6 -1 5 1 -2 35 3 -2 33 5 1 20 6 -1 6 2 -2 35 3 -2 34 5 1
 23 6 -1 9 1 -2 36 4 -2 33 5 1 26 6 -1 12 2 -2 36 4 -2 34 5 1 29 6 -1 15 3 -2 36
 4 -2 35 5 1 32 6 -1 18
 36 14 108 2577 2 0 0 3 1 0
 1 -2 3 2 -2 2 3 1 1 1 -2 5 2 -2 4 4 1 1 1 1 6 3 -2 4 4 -2 2 2 1 6 3 -2 5 4 -2 3
 1 -2 8 2 -2 7 5 1 1 1 -2 9 3 -2 7 5 1 2 1 0 3 3 -1 7 5 1 2 1 -1 9 3 0 3 5 1 2 2
 -2 9 3 -2 8 5 1 3 2 -1 9 3 0 3 5 1 3 2 0 3 3 -1 8 5 1 3 1 -2 10 4 -2 7 5 1 4 1
 0 3 4 -1 7 5 1 4 1 -1 10 4 0 3 5 1 4 2 -2 10 4 -2 8 5 1 5 2 -1 10 4 0 3 5 1 5 2
 0 3 4 -1 8 5 1 5 3 -2 10 4 -2 9 5 1 6 1 -2 12 2 -2 11 6 1 1 1 -2 13 3 -2 11 6 1
 2 1 0 3 3 -1 11 6 1 2 1 -1 13 3 0 3 6 1 2 2 -2 13 3 -2 12 6 1 3 2 -1 13 3 0 3 6
 1 3 2 0 3 3 -1 12 6 1 3 1 -2 14 4 -2 11 6 1 4 1 0 3 4 -1 11 6 1 4 1 -1 14 4 0 3
 6 1 4 2 -2 14 4 -2 12 6 1 5 2 -1 14 4 0 3 6 1 5 2 0 3 4 -1 12 6 1 5 3 -2 14 4 -2
 13 6 1 6 1 0 3 5 -1 11 6 1 7 2 0 3 5 -1 12 6 1 8 3 0 3 5 -1 13 6 1 9 4 0 3 5 -1
 14 6 1 10
 1 36 120 2685 3 1 0 6 2 0
 0 4 36 0 4 35 0 -2 32 0 2 18 0 4 36 0 -2 34 0 4 31 0 -4 17 0 4 35 0 -2 34 0 4
 25 0 -4 11 0 -2 32 0 4 31 0 4 25 0 0 36 0 2 18 0 -4 17 0 -4 11 0 0 36 0 4 36 0
 4 35 0 -2 32 0 2 18 0 4 36 0 -2 33 0 4 27 0 -4 13 0 4 35 0 -2 33 0 4 21 0 -4 7
 0 -2 32 0 4 27 0 4 21 0 0 36 0 2 18 0 -4 13 0 -4 7 0 0 36 0 -2 36 0 4 34 0 4 30
 0 -4 16 0 -2 36 0 4 33 0 4 28 0 -4 14 0 4 34 0 4 33 0 -2 19 0 2 5 0 4 30 0 4 28
 0 -2 19 0 0 36 0 -4 16 0 -4 14 0 2 5 0 0 36 0 -2 35 0 4 34 0 4 24 0 -4 10 0 -2
 35 0 4 33 0 4 22 0 -4 8 0 4 34 0 4 33 0 -2 19 0 2 5 0 4 24 0 4 22 0 -2 19 0 0
 36 0 -4 10 0 -4 8 0 2 5 0 0 36 0 1 32 0 -2 29 0 -2 23 0 -2 4 0 1 32 0 -2 26 0 -2
 20 0 -2 3 0 -2 29 0 -2 26 0 1 19 0 -2 2 0 -2 23 0 -2 20 0 1 19 0 -2 1 0 -2 4 0
 -2 3 0 -2 2 0 -2 1 0 -1 18 0 2 15 0 2 9 0 2 4 0 -1 18 0 2 12 0 2 6 0 2 3 0 2 15
 0 2 12 0 -1 5 0 2 2 0 2 9 0 2 6 0 -1 5 0 2 1 0 2 4 0 2 3 0 2 2 0 2 1
 1 6 6 2805 5 1 0 6 2 0
 1 -2 6 2 -2 5 3 -2 4 4 -2 3 5 1 2 6 -1 1
 6 13 30 2811 4 0 0 5 1 0
 1 -2 5 2 -2 4 3 -2 3 4 -2 2 5 1 1 1 -2 9 2 -2 8 3 -2 7 4 -2 6 6 1 1 1 2 11 2 2
 10 3 0 5 5 -1 6 6 1 2 1 2 13 2 2 12 4 0 5 5 -1 7 6 1 3 1 0 5 3 -2 12 4 -2 10 5
 -1 8 6 1 4 2 0 5 3 -2 13 4 -2 11 5 -1 9 6 1 5
 13 36 52 2841 3 0 1 4 0 0
 1 1 4 2 1 3 3 1 2 4 1 1 1 1 9 2 1 7 3 1 5 5 1 1 1 1 15 2 1 12 4 1 5 5 1 2 1 1
 18 3 1 13 4 1 6 5 1 3 2 1 18 3 1 16 4 1 10 5 1 4 1 1 23 2 1 21 3 1 19 6 1 1 1 1
 29 2 1 26 4 1 19 6 1 2 1 1 32 3 1 27 4 1 20 6 1 3 2 1 32 3 1 30 4 1 25 6 1 4 1
 -1 35 3 1 33 5 -1 22 6 1 8 2 -1 35 3 1 34 5 -1 24 6 1 11 1 -1 36 4 1 33 5 -1 28
 6 1 14 2 -1 36 4 1 34 5 -1 31 6 1 17
 1 13 30 2893 4 0 0 6 2 0
 0 0 13 0 4 13 0 4 11 0 2 9 0 -2 5 0 0 13 0 4 12 0 4 10 0 2 8 0 -2 4 0 -4 13 0 -4
 12 0 0 13 0 2 7 0 -2 3 0 -4 11 0 -4 10 0 0 13 0 2 6 0 -2 2 0 -2 9 0 -2 8 0 -2 7
 0 -2 6 0 1 1 0 2 5 0 2 4 0 2 3 0 2 2 0 -1 1
 1 14 360 2923 2 0 0 6 2 0
 0 0 14 0 0 14 0 0 14 0 0 14 0 0 14 0 0 14 0 0 14 0 0 14 0 0 14 0 0 14 0 0 14 0
 0 14 0 0 14 0 4 14 0 -4 10 0 0 14 0 -4 12 0 4 8 0 4 14 0 -4 12 0 0 14 0 -4 10 0
 4 8 0 0 14 0 0 14 0 4 13 0 -4 9 0 0 14 0 -4 12 0 4 8 0 4 13 0 -4 12 0 0 14 0 -4
 9 0 4 8 0 0 14 0 -4 14 0 -4 13 0 2 6 0 -4 14 0 2 12 0 -4 5 0 -4 13 0 2 12 0 -4
 3 0 2 6 0 -4 5 0 -4 3 0 4 10 0 4 9 0 -2 6 0 4 10 0 -2 8 0 4 5 0 4 9 0 -2 8 0 4
 3 0 -2 6 0 4 5 0 4 3 0 0 14 0 0 14 0 0 14 0 0 14 0 0 14 0 0 14 0 0 14 0 0 14 0
 0 14 0 0 14 0 0 14 0 0 14 0 0 14 0 4 14 0 -4 10 0 0 14 0 -4 11 0 4 7 0 4 14 0 -4
 11 0 0 14 0 -4 10 0 4 7 0 0 14 0 0 14 0 4 13 0 -4 9 0 0 14 0 -4 11 0 4 7 0 4 13
 0 -4 11 0 0 14 0 -4 9 0 4 7 0 0 14 0 -4 14 0 -4 13 0 2 6 0 -4 14 0 2 11 0 -4 4
 0 -4 13 0 2 11 0 -4 2 0 2 6 0 -4 4 0 -4 2 0 4 10 0 4 9 0 -2 6 0 4 10 0 -2 7 0 4
 4 0 4 9 0 -2 7 0 4 2 0 -2 6 0 4 4 0 4 2 0 0 14 0 -4 14 0 4 10 0 0 14 0 4 12 0 -4
 8 0 -4 14 0 4 12 0 0 14 0 4 10 0 -4 8 0 0 14 0 0 14 0 -4 14 0 4 10 0 0 14 0 4
 11 0 -4 7 0 -4 14 0 4 11 0 0 14 0 4 10 0 -4 7 0 0 14 0 0 14 0 0 14 0 0 14 0 0
 14 0 0 14 0 0 14 0 0 14 0 0 14 0 0 14 0 0 14 0 0 14 0 0 14 0 2 14 0 -4 12 0 -4
 5 0 2 14 0 -4 11 0 -4 4 0 -4 12 0 -4 11 0 2 1 0 -4 5 0 -4 4 0 2 1 0 -2 10 0 4 8
 0 4 5 0 -2 10 0 4 7 0 4 4 0 4 8 0 4 7 0 -2 1 0 4 5 0 4 4 0 -2 1 0 0 14 0 -4 13
 0 4 9 0 0 14 0 4 12 0 -4 8 0 -4 13 0 4 12 0 0 14 0 4 9 0 -4 8 0 0 14 0 0 14 0 -4
 13 0 4 9 0 0 14 0 4 11 0 -4 7 0 -4 13 0 4 11 0 0 14 0 4 9 0 -4 7 0 0 14 0 0 14
 0 0 14 0 0 14 0 0 14 0 0 14 0 0 14 0 0 14 0 0 14 0 0 14 0 0 14 0 0 14 0 0 14 0
 2 13 0 -4 12 0 -4 3 0 2 13 0 -4 11 0 -4 2 0 -4 12 0 -4 11 0 2 1 0 -4 3 0 -4 2 0
 2 1 0 -2 9 0 4 8 0 4 3 0 -2 9 0 4 7 0 4 2 0 4 8 0 4 7 0 -2 1 0 4 3 0 4 2 0 -2 1
 0 4 14 0 4 13 0 -2 6 0 4 14 0 -2 12 0 4 5 0 4 13 0 -2 12 0 4 3 0 -2 6 0 4 5 0 4
 3 0 4 14 0 4 13 0 -2 6 0 4 14 0 -2 11 0 4 4 0 4 13 0 -2 11 0 4 2 0 -2 6 0 4 4 0
 4 2 0 -2 14 0 4 12 0 4 5 0 -2 14 0 4 11 0 4 4 0 4 12 0 4 11 0 -2 1 0 4 5 0 4 4
 0 -2 1 0 -2 13 0 4 12 0 4 3 0 -2 13 0 4 11 0 4 2 0 4 12 0 4 11 0 -2 1 0 4 3 0 4
 2 0 -2 1 0 1 6 0 -2 5 0 -2 3 0 1 6 0 -2 4 0 -2 2 0 -2 5 0 -2 4 0 1 1 0 -2 3 0 -2
 2 0 1 1 0 -4 10 0 -4 9 0 2 6 0 -4 10 0 2 8 0 -4 5 0 -4 9 0 2 8 0 -4 3 0 2 6 0 -4
 5 0 -4 3 0 -4 10 0 -4 9 0 2 6 0 -4 10 0 2 7 0 -4 4 0 -4 9 0 2 7 0 -4 2 0 2 6 0
 -4 4 0 -4 2 0 2 10 0 -4 8 0 -4 5 0 2 10 0 -4 7 0 -4 4 0 -4 8 0 -4 7 0 2 1 0 -4
 5 0 -4 4 0 2 1 0 2 9 0 -4 8 0 -4 3 0 2 9 0 -4 7 0 -4 2 0 -4 8 0 -4 7 0 2 1 0 -4
 3 0 -4 2 0 2 1 0 -1 6 0 2 5 0 2 3 0 -1 6 0 2 4 0 2 2 0 2 5 0 2 4 0 -1 1 0 2 3 0
 2 2 0 -1 1
 1 6 6 3283 5 1 0 6 2 0
 1 1 6 2 1 5 3 1 4 4 1 3 5 2 2 6 -2 1
 0 0 0 0 0 0 0 0 0 0
 0 0 0 0 0 0 0 0 0 0
