 3 3 1 0 1 2 3
 1 3 3 1 2 2 0 3 3 0
 1 1 3 2 -1 2 3 1 1
 3 3 6 4 1 1 0 2 2 0
 1 1 2 2 -1 1 1 1 3 3 -1 1 2 1 3 3 -1 2
 3 1 3 10 0 0 0 1 1 0
 1 1 1 2 1 1 3 1 1
 1 3 3 13 2 2 0 3 3 0
 1 1 3 2 -1 2 3 1 1
 1 3 6 16 1 1 0 3 3 0
 0 1 3 0 -1 2 0 -1 3 0 1 1 0 1 2 0 -1 1
 1 1 6 22 0 0 0 3 3 0
 0 1 1 0 -1 1 0 -1 1 0 1 1 0 1 1 0 -1 1
 0 0 0 0 0 0 0 0 0 0
 0 0 0 0 0 0 0 0 0 0
