 5 1 1 0 1 2 3 4 5
 1 18 20 1 3 1 2 5 1 0
 0 -2 18 0 1 17 0 1 12 0 -2 7 0 -2 18 0 1 15 0 1 10 0 -2 5 0 1 16 0 1 14 0 -2 9
 0 -2 3 0 1 13 0 1 11 0 -2 9 0 -2 1 0 -2 8 0 -2 6 0 -2 4 0 -2 2
 18 22 54 21 2 0 2 3 1 2
 1 1 5 2 1 3 3 -2 1 1 1 4 2 1 2 3 -2 1 1 1 8 2 1 6 4 -2 1 1 1 9 2 1 7 4 -2 1 1 -2
 10 3 1 7 4 1 2 1 -2 10 3 1 6 4 1 3 2 -2 10 3 1 9 4 1 4 2 -2 10 3 1 8 4 1 5 1 -2
 15 2 -2 12 5 1 1 1 -2 17 3 -2 13 5 1 2 1 -2 19 3 -2 11 5 1 3 2 -2 17 3 -2 16 5
 1 4 2 -2 19 3 -2 14 5 1 5 1 -2 22 4 -2 11 5 1 6 1 -2 21 4 -2 13 5 1 7 2 -2 22 4
 -2 14 5 1 8 2 -2 21 4 -2 16 5 1 9 3 -2 20 4 -2 18 5 1 10
 22 5 44 75 1 0 1 2 0 2
 1 1 2 2 1 1 1 1 3 3 -2 1 1 -2 3 3 1 1 2 1 3 3 -2 2 2 -2 3 3 1 2 1 -2 4 4 1 1 1
 1 4 4 -2 1 2 -2 4 4 1 2 2 1 4 4 -2 2 3 1 4 4 1 3 1 -2 5 5 1 1 1 1 5 5 1 1 1 1 5
 5 -2 1 2 -2 5 5 1 2 2 1 5 5 1 2 2 1 5 5 -2 2 3 -2 5 5 1 3 3 1 5 5 1 3 3 1 5 5 -2
 3 4 1 5 5 1 4 4 -2 5 5 1 4 4 1 5 5 -2 4
 5 1 5 119 0 0 0 1 0 1
 1 1 1 2 1 1 3 1 1 4 1 1 5 1 1
 1 22 60 124 2 0 2 5 1 0
 0 -2 21 0 -2 17 0 4 10 0 -2 22 0 4 15 0 -2 8 0 -2 19 0 4 15 0 -2 5 0 4 10 0 -2
 9 0 -2 4 0 -2 21 0 -2 17 0 4 10 0 -2 22 0 4 12 0 -2 6 0 -2 19 0 4 12 0 -2 3 0 4
 10 0 -2 7 0 -2 2 0 4 20 0 -2 16 0 -2 9 0 4 20 0 -2 13 0 -2 7 0 -2 14 0 -2 11 0
 4 1 0 -2 8 0 -2 6 0 4 1 0 4 18 0 -2 16 0 -2 4 0 4 18 0 -2 13 0 -2 2 0 -2 14 0 -2
 11 0 4 1 0 -2 5 0 -2 3 0 4 1 0 -2 10 0 1 9 0 1 4 0 -2 10 0 1 7 0 1 2 0 1 8 0 1
 6 0 -2 1 0 1 5 0 1 3 0 -2 1
 1 18 60 184 2 1 1 5 1 0
 0 -2 18 0 -2 17 0 4 14 0 -2 18 0 1 16 0 -2 13 0 -2 17 0 1 16 0 -2 7 0 4 14 0 -2
 13 0 -2 7 0 -2 18 0 -2 17 0 4 14 0 -2 18 0 1 15 0 -2 9 0 -2 17 0 1 15 0 -2 4 0
 4 14 0 -2 9 0 -2 4 0 1 18 0 -2 16 0 -2 12 0 1 18 0 -2 15 0 -2 10 0 -2 16 0 -2
 15 0 4 1 0 -2 12 0 -2 10 0 4 1 0 1 17 0 -2 16 0 -2 6 0 1 17 0 -2 15 0 -2 3 0 -2
 16 0 -2 15 0 4 1 0 -2 6 0 -2 3 0 4 1 0 -2 14 0 4 11 0 4 5 0 -2 14 0 4 8 0 4 2 0
 4 11 0 4 8 0 -2 1 0 4 5 0 4 2 0 -2 1
 18 5 36 244 1 0 1 2 1 1
 1 1 2 2 1 1 1 1 3 3 1 1 1 1 3 3 -2 1 1 -2 3 3 1 1 2 1 3 3 1 2 2 1 3 3 -2 2 2 -2
 3 3 1 2 1 1 4 4 1 1 1 -2 4 4 1 1 1 1 4 4 -2 1 2 1 4 4 1 2 2 1 4 4 -2 2 2 -2 4 4
 1 2 3 1 4 4 1 3 1 -2 5 5 1 1 2 -2 5 5 1 2 3 -2 5 5 1 3 4 -2 5 5 1 4
 1 5 120 280 1 0 1 5 1 0
 0 -2 5 0 4 4 0 -2 5 0 4 3 0 4 4 0 4 3 0 4 5 0 -2 4 0 4 5 0 4 2 0 -2 4 0 4 2 0 4
 5 0 -2 3 0 4 5 0 4 2 0 -2 3 0 4 2 0 4 4 0 4 3 0 4 4 0 -2 2 0 4 3 0 -2 2 0 -2 5
 0 4 4 0 -2 5 0 4 3 0 4 4 0 4 3 0 4 5 0 -2 4 0 4 5 0 4 1 0 -2 4 0 4 1 0 4 5 0 -2
 3 0 4 5 0 4 1 0 -2 3 0 4 1 0 4 4 0 4 3 0 4 4 0 -2 1 0 4 3 0 -2 1 0 4 5 0 4 4 0
 4 5 0 -2 2 0 4 4 0 -2 2 0 4 5 0 4 4 0 4 5 0 -2 1 0 4 4 0 -2 1 0 -2 5 0 4 2 0 -2
 5 0 4 1 0 4 2 0 4 1 0 -2 4 0 4 2 0 -2 4 0 4 1 0 4 2 0 4 1 0 4 5 0 4 3 0 4 5 0 -2
 2 0 4 3 0 -2 2 0 4 5 0 4 3 0 4 5 0 -2 1 0 4 3 0 -2 1 0 -2 5 0 4 2 0 -2 5 0 4 1
 0 4 2 0 4 1 0 -2 3 0 4 2 0 -2 3 0 4 1 0 4 2 0 4 1 0 -2 4 0 -2 3 0 -2 4 0 1 2 0
 -2 3 0 1 2 0 -2 4 0 -2 3 0 -2 4 0 1 1 0 -2 3 0 1 1 0 1 4 0 -2 2 0 1 4 0 -2 1 0
 -2 2 0 -2 1 0 1 3 0 -2 2 0 1 3 0 -2 1 0 -2 2 0 -2 1
 1 5 120 400 1 1 0 5 1 0
 0 1 5 0 -2 4 0 1 5 0 -2 3 0 -2 4 0 -2 3 0 -2 5 0 4 4 0 -2 5 0 4 2 0 4 4 0 4 2 0
 -2 5 0 4 3 0 -2 5 0 4 2 0 4 3 0 4 2 0 4 4 0 4 3 0 4 4 0 -2 2 0 4 3 0 -2 2 0 1 5
 0 -2 4 0 1 5 0 -2 3 0 -2 4 0 -2 3 0 -2 5 0 4 4 0 -2 5 0 4 1 0 4 4 0 4 1 0 -2 5
 0 4 3 0 -2 5 0 4 1 0 4 3 0 4 1 0 4 4 0 4 3 0 4 4 0 -2 1 0 4 3 0 -2 1 0 -2 5 0 4
 4 0 -2 5 0 4 2 0 4 4 0 4 2 0 -2 5 0 4 4 0 -2 5 0 4 1 0 4 4 0 4 1 0 1 5 0 -2 2 0
 1 5 0 -2 1 0 -2 2 0 -2 1 0 -2 4 0 4 2 0 -2 4 0 4 1 0 4 2 0 4 1 0 -2 5 0 4 3 0 -2
 5 0 4 2 0 4 3 0 4 2 0 -2 5 0 4 3 0 -2 5 0 4 1 0 4 3 0 4 1 0 1 5 0 -2 2 0 1 5 0
 -2 1 0 -2 2 0 -2 1 0 -2 3 0 4 2 0 -2 3 0 4 1 0 4 2 0 4 1 0 4 4 0 4 3 0 4 4 0 -2
 2 0 4 3 0 -2 2 0 4 4 0 4 3 0 4 4 0 -2 1 0 4 3 0 -2 1 0 -2 4 0 4 2 0 -2 4 0 4 1
 0 4 2 0 4 1 0 -2 3 0 4 2 0 -2 3 0 4 1 0 4 2 0 4 1
 5 1 5 520 0 0 0 1 1 0
 1 1 1 2 1 1 3 1 1 4 1 1 5 1 1
 1 5 5 525 4 1 1 5 1 0
 1 1 5 2 1 4 3 1 3 4 1 2 5 -2 1
 5 14 20 530 3 0 1 4 1 1
 1 1 4 2 1 3 3 1 2 4 1 1 1 -2 9 2 -2 6 3 -2 5 5 1 1 1 -2 13 2 -2 11 4 -2 5 5 1 2
 1 -2 14 3 -2 10 4 -2 7 5 1 3 2 -2 14 3 -2 12 4 -2 8 5 1 4
 14 10 42 550 2 0 0 3 0 1
 1 -2 3 2 -2 2 3 1 1 1 -2 5 2 -2 4 4 1 1 1 1 6 3 -2 4 4 -2 2 2 1 6 3 -2 5 4 -2 3
 1 -2 8 2 -2 7 5 1 1 1 -2 9 3 1 7 5 -2 2 1 1 9 3 -2 7 5 -2 2 2 1 9 3 -2 8 5 -2 3
 2 -2 9 3 1 8 5 -2 3 1 1 10 4 -2 7 5 -2 4 1 -2 10 4 1 7 5 -2 4 2 1 10 4 -2 8 5 -2
 5 2 -2 10 4 1 8 5 -2 5 3 -2 10 4 -2 9 5 1 6
 10 5 20 592 1 0 1 2 0 0
 1 1 2 2 1 1 1 1 3 3 1 1 2 1 3 3 1 2 1 1 4 4 1 1 2 1 4 4 1 2 3 1 4 4 1 3 1 1 5 5
 1 1 2 1 5 5 1 2 3 1 5 5 1 3 4 1 5 5 1 4
 1 14 20 612 3 0 1 5 1 0
 0 -2 14 0 -2 13 0 -2 9 0 -2 4 0 -2 14 0 -2 11 0 -2 6 0 -2 3 0 -2 12 0 -2 10 0 -2
 5 0 -2 2 0 -2 8 0 -2 7 0 -2 5 0 -2 1 0 1 4 0 1 3 0 1 2 0 1 1
 1 10 20 632 3 1 0 5 1 0
 0 1 10 0 -2 9 0 -2 7 0 -2 4 0 1 10 0 -2 8 0 -2 6 0 -2 3 0 -2 9 0 -2 8 0 1 5 0 -2
 2 0 -2 7 0 -2 6 0 1 5 0 -2 1 0 -2 4 0 -2 3 0 -2 2 0 -2 1
 10 10 30 652 2 0 0 3 1 0
 1 -2 3 2 -2 2 3 1 1 1 -2 5 2 -2 4 4 1 1 1 1 6 3 -2 4 4 -2 2 2 1 6 3 -2 5 4 -2 3
 1 -2 8 2 -2 7 5 1 1 1 -2 9 3 -2 7 5 1 2 2 -2 9 3 -2 8 5 1 3 1 -2 10 4 -2 7 5 1
 4 2 -2 10 4 -2 8 5 1 5 3 -2 10 4 -2 9 5 1 6
 1 5 5 682 4 0 0 5 1 0
 1 -2 5 2 -2 4 3 -2 3 4 -2 2 5 1 1
 5 14 20 687 3 0 1 4 0 0
 1 1 4 2 1 3 3 1 2 4 1 1 1 1 8 2 1 7 3 1 5 5 1 1 1 1 12 2 1 10 4 1 5 5 1 2 1 1
 14 3 1 11 4 1 6 5 1 3 2 1 14 3 1 13 4 1 9 5 1 4
 1 10 60 707 2 0 0 5 1 0
 0 4 10 0 4 9 0 -2 6 0 4 10 0 -2 8 0 4 5 0 4 9 0 -2 8 0 4 3 0 -2 6 0 4 5 0 4 3 0
 4 10 0 4 9 0 -2 6 0 4 10 0 -2 7 0 4 4 0 4 9 0 -2 7 0 4 2 0 -2 6 0 4 4 0 4 2 0 -2
 10 0 4 8 0 4 5 0 -2 10 0 4 7 0 4 4 0 4 8 0 4 7 0 -2 1 0 4 5 0 4 4 0 -2 1 0 -2 9
 0 4 8 0 4 3 0 -2 9 0 4 7 0 4 2 0 4 8 0 4 7 0 -2 1 0 4 3 0 4 2 0 -2 1 0 1 6 0 -2
 5 0 -2 3 0 1 6 0 -2 4 0 -2 2 0 -2 5 0 -2 4 0 1 1 0 -2 3 0 -2 2 0 1 1
 1 5 5 767 4 0 0 5 1 0
 1 1 5 2 1 4 3 1 3 4 1 2 5 -2 1
 0 0 0 0 0 0 0 0 0 0
 0 0 0 0 0 0 0 0 0 0
